0	1
عیار طلا	Gold karat
تفاوت کمک هزینه با مستمری	difference between allowance and pension
مشخصات مورد اجاره	Specifications of the lease object
شرایط تسلیم عین مستاجره	conditions for the handover of the lease object
واحد وظیفه عمومی نیروی انتظامی	Public conscription organisation of the Islamic Republic of Iran's law enforcement force (NAJA)
لایه اشکی	tear film layer
کولارت	Collarettes
برجستگی دهانه غدد مشاهده می‌شود	The inflammation of gland's opening is seen.
کارت معافیت از خدمت دوره ضرورت	Active-duty [Military] Service Exemption Card
فلیکتن ملتحمه	Phlyctenular Conjunctivitis
مسئول اداره	office manager
محل تنظیم سند]: شهرستان شمیرانات، بخش لواسانات، شهر تجریش]	Place of issue: County: Shemiranat, District: Lavasanat, City: Tajrish
رای غيابی دادگاه	default judgment
تعرفه حق الوکاله وکیل	allowable attorney’s fees
هزینه دادرسی	all legal expenses; litigation expenses
محکوم به پرداخت جزای نقدی	sentenced to pay fine
قانون ثبت اسناد و املاک کشور	the registration of deeds and property law
محاکم محترم	honourable courts
ابلاغ رای دادگاه	delivering this judgment in writing
مطالبه خسارت دادرسی	claiming for all legal expenses; claiming for litigation expenses
مصدق اسناد و مدارک	the certified copies of deeds and documents
شعبه دوم ناحيه ۱۲ دادسرای عمومی و انقلاب تهران	Public prosecutor's office division two in district 12, Tehran public and revolutionary court
دادياری	Office of the assistant to the public prosecutor
گواهی انحصار وراثت	certificate of inheritance exclusivity; certificate of inheritance
مورد وكالت (زمین)	subject-matter of the POA; subject-matter of the power of attorney
وکیل و موکل	attorney and client
مورد معامله (زمین)	property under the deal; subject matter of the transaction (land)
مبايعه نامه	Purchase and Sale Agreement (PSA)
دادرسی	judgment; proceedings
دادخواست	Statement of Claim
دادسرای ناحيه ۲۵ تهران	Tehran Court District 25; Tehran (Public) Prosecutor's Office, District 25
دادستان عمومی وانقلاب تهران	prosecutor for the public and revolutionary courts of Tehran
خواهان و خوانده (اصحاب دعوی)	plaintiff and defendant
شعبه ۱۱۰ دادگاه عمومی حقوقی	Division 110 of the Public Court of Law
دادگستری كل استان تهران	Tehran Court of Justice
تاريخ تنظيم دادنامه	Date of judgement
تصوير برابر با اصل است	This is a true copy of the original.
رعایت انضباط در سیاست مالی	observing/following discipline/order in financial policy
راه‌هایی برای خنثی‌سازی کسری بودجه	ways to neutralize/overcome budget deficit
رشد ۱۲۰۰ هزار میلیارد تومانی نقدینگی	(...this deficit can) grow liquidity by 1.2 quadrillion tomans
چند باری میان بهارستانشینان و دولتی‌ها در رفت‌وآمد بود	...was circulated several times between the Baharestanis and the government side...
زن سرپرست خانواده	female head-of-household, bread-winning woman
صدور حکم	to issue a verdict
کرونا در مرحلۀ اولیه تشخیص های افتراقی‌ متعددی دارد	COVID-19 in its early stage has a number of differential diagnoses.
امضای مامور و امضای مسئول	officer's signature and office manager's signature; registrar's signature and the signature of the officer-in-charge
شماره ملی	National Number; National Identity Number
توضیحات شناسنامه	annotations
مدیر کل	general manager, general director
گواهی اشتغال به تحصیل	enrollment certificate
بیماری زمینه ای	underlying medical condition
گرم شدن تدریجی آب و هوا	gradual warming of the weather
کارشناس هوشبری	anaesthetist, nurse anesthetist
مدل‌های آب‌و‌هوایی پیش‌بینی می‌کنند که تا سال 2100	Climate models predict that ... by 2100
بیشترین سهم اثر گلخانه‌ای مربوط به دی‌اکسیدکربن	Carbon dioxide contributes the most to the greenhouse effect
بارش رگبارهای سیل آسا	Torrential raining
باعث به وجود آمدن بسیاری از مشکلات کنونی	has led to many of the current problems
یگان‌های شناور	maritime units
صاحب اندیشه می‌شود	Becomes wise
رایانامه	email
پدرسوخته	You naughty little kid
تاریخ، امضا و مهر ثبت احوال صادر کننده	The date, signature, and stamp of the issuing Civil Registry Office
تاریخ تنظیم سند [شناسنامه]	[BC] Date of issue
محل تولد: شهرستان تهران، بخش مرکزی، شهرتهران	Place of birth: Tehran, Central District
از یابنده تقاضا می شود کارت را به صندوق پست بیندازد.	The finder is requested to drop this card into a street posting box.
الزام قانونی	legal requirement
پزشکی قانونی	Legal medicine
معاون اموزشی	Vice-chancellor for Education
بخشنامه	circular, directive
يَرْفَعِ اللَه الَّذِينَ آمَنُوا مِنْكُمْ وَ الَّذِينَ أُوتُوا الْعِلْمَ دَرَجات	Allah will exalt those who believe among you, and those who have knowledge, to high ranks.
دادسرای عمومی و انقلاب	Public and Revolutionary Office of the Prosecutor
کارشناس رشته ...	expert in the field of...
قطع رابطه استخدامی	Termination of employment relationship
بچه‌ام را از سر راه نیاورده‌ام که	my child/baby was not left/found on the church steps
رسیدن	Lead to
آثار هاله ای	visual aura
فقیه	faqīh, Islamic jurist
به رسمیت شناختن افراد	To officially recognize individuals
در وجود	being
پیش پای پدرم گل گذاشتن	they placed flowers at my father's feet
دفترعمومی ثبت دانشنامه ها	General Register Office for Degree Certificates
مدير كل دفتر امور فارغ التحصيلان	General Director of the Alumni Affairs Dept.
بدون خط خوردگی و خدشه	with no strike-through or damage
مشخصات واقعه وفات	Specifications of the death event
بیماری های قلبی	Heart diseases
اداره کل امور اسناد و سردفتران	General Department of Deeds and Heads of Notaries' Affairs
شناسنامه المثنی	Replacement Birth Certificate
موهایت که پریشان شود	When your hair gets disheveled
برای صبح شدن به خورشید و خنده‌های باد نیاز نیست	Morning\'s arrival needs neither sun nor wind\'s laughter
سربلند کردن	to elevate / make glorious / glorify
به خودت نگیر	Don\'t take it personally
درجا زدن	Stagnate
تدابیر شدید امنیتی	stringent security measures
از تصدقِ سرِ سرکار همایون، خوب و مشغول دعاگویی هستم.	Due to kind support of your excellency, I am great and well-wisher
انحلال قرارداد	contract dissolution
عقود لازم	binding contracts
نهایتاً تا۲۴ ساعت بعد ازانعقاد قرارداد	up to 24 hours after the conclusion of contract
مالیات بر ارزش افزوده	value added tax (VAT)
متعاملین	Parties to the transaction
اشخاص حقیقی و حقوقی	natural individuals (real persons)  legal entities
تا زمان تحویل ملک	till the handover date of the premises
تنظیم قرارداد اجاره	drawing up a residential tenancy agreement
...در موارد سکوت این قرارداد	In cases not included in the contract herein, ...
اسقاط کافه خیارات ولوخیارغبن فاحش	Waiving all options including the option of gross loss
خیار تدلیس	option of deceit
خیار غبن	option of loss
بلامانع است	is permitted; is allowed
سرقفلی مغازه	Goodwill
عوارض کسب و پیشه شهرداری	Business and Occupation (B) tax levied by the municipality
واحد صنفی املاک	Real Estate Agency; Real Estate Guild Unit
مدارک و مستندات مورد معامله	Documents and deeds related to the object of transaction
عرف	conventional practice; common practice
استیفا	Using someone's property with their consent
شرایط تسلیم عین مستاجره	Conditions for the lease object's handover
کولر آبی	Evaporative air cooler
پلاک ثبتی فرعی	registered sub-plate [No. ...]
تملیک منافع	Possession of benefits
مشخصات مورد اجاره	The Object of Lease's specifications; Specifications of the Object of Lease
موضوع قرارداد	Subject of the agreement
صورت جلسه تفکیکی	division proceedings
انتقال قطعی ملک	absolute conveyance; irrevocable transfer of the real estate property
حقوق ارتفاقی ملک	property's easement rights
قدرالسهم از عرصه و سایر مشاعات و مشترکات	Proportionate share from the building site and other shared and communal areas
قطعه ۲ تفکیکی	Divided lot No. 2
سه دانگ عرصه و اعیان	Three [out of the entire six] shares of the building site and superstructure
فوق تخصص	Subspecialty
کارشناس پیراپزشکی	An expert in an allied healthcare field
پیراپزشکی	Allied healthcare field; Paramedicine
شیوه نامه	Guideline(s)
آزمایش های موجه	eligible tests; justifiable tests
پزشک معرف	referring physician
آگاهی نامه	information letter, notification letter
آگاهی نامه اطلاعات برای بیماران	fact sheet for patients
ترکیب شیمیایی	chemical composition
کتابچه راهنما	instruction manual; guide
موجود زنده	living organism; organism
تک نسخه‌ای	in one copy; single-copy
اومحکومیت کیفری ندارد	They have no penal conviction.
اساسنامه شرکت	Company's Articles of Association
مطالبات حال شده و آورده نقدی	matured claims and cash contributions
مجمع عمومی فوق العاده سازمان	extraordinary general assembly of the organisation
صورت جلسه	Minutes
این گواهی نامه یک نسخه است و از آن رونوشت یا المثنی داده نمی شود	This certificate is issued in one copy and other copies or duplicates will not be provided.
معدل کتبی نهایی	Final written average
دیپلم علوم تجربی	Certificate for completing secondary education [High school graduation diploma] in the field of experimental sciences
مراتب فوق	Thereof; the above-said; the above-mentioned
به زوجه وکالت بلاعزل با حق توکیل غیر داد	[The husband] gave the wife an irrevocable power of attorney with the right of substitution
وام بلاعوض	Grant
(معرفین (ازدواج	References: First referee, Second referee
جد پدری	paternal grandfather
اداره ثبت احوال بهشت زهرا	Behesht-e Zahra Civil Register Office; Behesht-e Zahra Civil Status Registry Office
تاریخ وقوع عقد	Date of marriage solemnisation
دفن متوفی بلامانع است	Burying the deceased is allowed /unrestricted.
جواز دفن	Burial permit
درگیری شدید دو طرفه ریه ها	Severe bilateral lung involvement
تاریخ فوت	date of death (DOD)
حق‌الناس	The right of the people
ندا و منادا	interjection letter  vocative
پاكسازي كردن	cleansing
حكم افزايش حقوق وظيفه وراث	Legatees'/Heirs'/Survivors' Pension Increment/Increase Order/Directive/Personnel Action
سامانه	system
خدمات غیرحضوری	remote services
فیش مستمری	Pension payslip
تبصره ۱ ماده ۷۶ قانون	Note 1 to Article 76 of the law
تاریخ برقراری حکم افزایش مستمری	pension increase order's date of issue
امریه سربازی	substitute service; civilian service; alternative service
حکم افزایش مستمری	Pension Increase Order
بسمه تعالی	In the name of God, the Almighty; In his name, the Almighty
اداره کل	General Department; Directorate; General Office; Directorate-General
صلح عمری	Gift [deed] with lifetime ownership [of the real estate]
شخص تخصیص یافته	designated / assigned person
اسناد رهنی	mortgage documents
عقود ناقله	transferable contract
صلح خیاری	Optional Compromise
سیستم	System
آورده	Contribution/ share of investment/ share of stock
TAT (Turnaround Time)	موعد/زمان تحویل؛ زمان مورد نیاز برای تکمیل پروژه
ثبت احوال	Civil Registration
میزان جانبازی	Veteran disability compensation rate
نمره تجدیدی	Renewal score
افزایش همسان‌سازی	Increasing synchronization
فرسودگی تحصیلی دانشجویان سال ششم دندانپزشکی	Academic burnout of the sixth-year dentistry/dental students
بیمه: آزاد	Insurance: None
قدرالسهم	proportionate share
ولایت قهری	natural guardianship
ملک طلق	freehold; freehold land; freehold estate
Attention Deficit Hyperactivity Disorder (ADHD)	اختلال کم‌توجهی-بیش‌فعالی
medical administrator	سرپرست پزشکی؛ مسئول پزشکی؛ سرپرست بخش پزشکی؛ مسئول بخش پزشکی
جهیزیه	dowry
سونداژ ادراری	urinary catheterization; urinary catheterisation
ترک اعتیاد	addiction recovery; overcoming drug addiction; drug addiction recovery
مهریه سنگین	excessive marriage portion (Mahr)
انتقال قطعی در سند قطعی	absolute conveyance on a binding deed
لازم الاجرا	legally-binding; enforceable by law
واجب الاجرا	peremptory
خط خوردگی یا قلم خوردگی نسخه پزشک	alteration/ cross-out on doctor's prescription
شرایط ضمن عقد یا عقد خارج لازم	Stipulations in the marrige contract or by a separate [legally] binding contract
اداره ‌كل آموزش و پرورش شهر تهران	General office of education-Tehran
غیرقابل اعتراض	non-appealable
دادسرای عمومی و انقلاب تهران	Tehran’s Public  Revolutionary Court; Tehran’s Public  Revolutionary Tribunal
گواهینامه عدم سوء پیشینه	Clear Criminal Record Certificate
مهلت واخواهی	period to lodge an appeal [against the court's decision]; period to lodge a protest
پشت نویسی چک؛ ظهرنویسی چک	to endorse a check; to endorse a cheque
سند مالکیت کاداستری	Cadastre ownership document
گرایش رشته تحصیلی	sub-discipline of the academic discipline; concentrating on; concentration
دوره کارشناسی ارشد ناپیوسته	non-continuous master's degree program
قطب علمی	Center of Excellence
اهل علم	scientist/man or woman of science
وکالت شفاهی	oral power of attorney
میزان قرار تأمین	Amount of the writ of garnishment
مدیر کل اداره کل استاندارد استان	Director General of the General Department of Standards of the Province
مدیر کل تعزیرات حکومتی استان	General Director of the Governmental Discretionary Punishments Organization of the Province
کارشناسی حرفه ای	Professional bachelor
متخصص طب انتقال خون	Blood transfusion specialist
سکه طلا یک بهار آزادی رایج صداق فوق	Circulating, [size] One Bahār-e Āzādī gold coin as marriage portion (Mahr)
ولی زوجه	The wife's father and grandfather
عقد ازدواج	marriage contract
چهار اداره‌كل و شش مديريت	Four general directorates and six administrations
دوره دانشپذیری	Pre-Studentship (Program)
ایجاد نشاط و بالندگی	Creating vitality and growth
کاردان فنی عمران	Civil Engineering Technician
كارهاي عمومي ساختمان	General Construction Works
روسازی راه	Road surfacing
دلایل و منضمات دادخواست	reasons for the petition and attachments thereof
برای کوچکی شما	to be your servant or to serve you
صدای بم و خش‌دار	a deep, scratchy voice
سودای خام چیزی را در سر پختن	To indulge in wishful thinking/have wishful thinking
به حالت روحی خاصی دچار شدن	I was in a special/particular state of mind
شرعاً سهمی از ماترک پدربزرگم نداشتم	I had no legal right to any share in my grandfather's property.
حرمتی چنانکه باید پیش پدربزرگم نداشتند	they did not have the proper respect from my grandfather
همۀ مهر و علاقۀ پدربزرگم را به خود اختصاص داده بودند	They took/got all the love and affection of my grandfather.
دیگر لطفی از زندگی در جوار آنها حس نمی‌کرد	My mother who saw no point in living with them any more
برای هفت پشتش بس است	enough for a lifetime; to have more than one's fair share
خسارات جانی و مالی فراوانی به مردم وارد شد	people incurred extensive loss of life and property damage
جولانگاه نیروهای روسی و عثمانی بود	It was a hotbed of Russian and Ottoman forces
تنها یادگار تلاش‌های پدرمان هستیم	We are only relics of our father's endeavors
در تمام مقاطع حساس کشور حضور داشته‌ام	I have been there in all the critical moments in the country
باید حافظ نظم و امنیت کشور باشند	should protect order and security of the country
مجمع عالی حکمت اسلامی	The Supereme Council of Islamic Wisdom
اختلال هذیانی در بیماران سرپایی	Delusional disorder among outpatients
اوراق اختیار فروش تبعی	bonds with an embedded put option
مجله علمی-ترویجی	Review journal
خرده مقیاس‌	subscale
تنظیم هیجان	excitement regulation
اصالت	Roots
ادواری	periodic
مرتع داری	Rangeland management
مدیریت تحصیلات تکمیلی و استعدادهای درخشان	Postgraduate education and Exceptional Talents Administration
اجرای صحنه ای	stage performance
نامه قطعیت	Confirmation letter
نفوذ کردن	to infiltrate
آجودانی	adjutancy
یگان عمده مستقل	Major Independent Unit
رکن یکم یگان	First Section of the Unit
کیفری	criminal/penal
کارت نمونه	sample signature card
ترازنامه عملیات	operation balance sheet
مجمع عادی به طور فوق العاده	Extraordinary general meeting (EGM)
مدیر تسویه	liquidation manager / liquidation officer
قرار تامین دلیل	Writ of security
جرح شهود	Witness impeachment
واخواهی	lodging a protest/appeal
رای بدوی	initial judgment
احضار	Summoning, summons
ممنوع المعامله	barred from transaction
هزینه ایجاد کردن	Fabricate expenses
سود سهام مدیریتی	The managerial dividend
زمین ویلایی	House-lot
تشبیه جمع	singular to plural simile, plural simile
الهی به من ان ده	O God, give me that, which is better
رد مال	Restitution of property
قرار جلب به دادرسی	writ of summons or summons to attend the hearing
خیام خوانی/ رباعی خوانی	Reciting Khayyam's poems/Rubaʿis
حلال شدن	become legitimate
عده نگه داشتن	Observe the period of waiting/iddah
مقاومت در مقابل بازداشت قانونی	Resisting lawful Arrest
مقام ذیصلاح قضایی	competent judicial authority
حد سود و حد ضرر	Take profit  stop loss
تامین از طریق اینترنت	Internet procurment
اکوی طبیعی	normal echo
منحنی 60% پرسنتایل	equals to 60th percentile
عمیق	Deep
تعدیلی	moderated
زیرآبی رفتن	to be a double-dealer
ارشد معافی(معافی)	English for MA students (Exempted Course)
هم ورودی	Fellow student in the same year of entrance
معاونت نیروگاه ها	Power Plants Vice Presidency
کارگر عمومی بنای سفت کار	Masonry Worker or Mason
عدم حضور جلب است	Failure to appear in court results in the issuance of arrest warrant
فرمانداری ویژه	Special governorate
واهرسازی و جواهرفروشی	Jewelry Making Lab and Jewellery shop
مطالبه خسارات دادرسی	claiming for proceedings fee/adjudication costs
به قید فوریت	with urgency
کیفیت امر ابلاغ	The manner of serving (the writ)
دادیاری دادسرای عمومی و انقلاب	Assistant prosecutor of the pubilc and revolutionary prosecutor\'s office
سوابق ارفاقی	Ex gratia records
اعسار از هزینه دادرسی	unable to afford adjudication costs/fees/ court fees/ legal procedure fees/costs
اقامت تحصیلی	Study Permit, student residence permit
قبولا	by acceptance
ایجابا	By offer
زمین شهری	Urban land
سپردن ضمان درک	Ensuring guarantee to indemnify
احضار شونده	The summoned party
قانون قطبهای کشاورزی	Agricultural Poles Act
‌قانون مرجع تشخیص اراضی موات و ابطال اسناد آن	Reference law for identification of dead lands and revocation/annulment of their title deeds
سپردن تعهد تخلیه	to give/entrust evacuation commitment
آگهی گیرنده	ad publisher
نفرات اضافه	additional persons
توابع شرعیه	(all) religiously recognized appurtenances
شعبه حقوقی دادگستری	legal branch of the judiciary
اداره کل مشترکین و متقاضیان ارتباطات سیار	general directorate of subscribers and applicants for Mobile Telecommunication
ارزش تام بیهوشی	Total anesthesia cost
درجه دو	Level Two
آزاد	Private
جبهه حق علیه باطل	The front of truth against that of falsehood
بهره وری	Productivity
مرکز هزینه	Cost center
محرمیت	Nikah mut\'ah/Sigheh/temporary marriage
حق جذب پرداختی	paid allowance
ماموریت نیم روز	half-day assignment
استعلام گواهینامه	Driver License Letter of Verification/Driver License verification form
ترمیمی	restorative dentistry
نظام پزشکی و طب قانونی	Medical council and forensic medicine
دوره دکتری عمومی	General medicine doctorate
کارشناس عالی	Chief Expert
سکه نیم بهار آزادی	Half Bahar-e Azadi Gold Coin
عالم امکان	possible world
دزد ناموس	Wencher/philanderer
دستت بشکنه	God damn you
پول کسی را خوردن	swindle out of money
ضابط	Bailiff
از دست کسی اسایش نداشتن	fail to get rid of someone
کله پز	Kalleh paz
کالبدی	Physical
دادگاه تجدید نظر امور مهاجرت شهر لندن	Special immigration appeals commission
شعبه بازپرسی	Investigation unit
قابل نظرخواهی	Can be appealed
عنایات رهبری	Exemption by leader\'s gift/mercy
معرفی کردن	appear before
کد ممنوع الخروجی	exit ban number
طهارت غیرمواقعه	Unpuctuated woman while in pureness state
پاسخ منقضی	The needed / appropriate answer
احیای حق	Reclaiming your rights
اجرای مفاد قرار داد	Implementation/execution of the provisions of the contract
حق و حقوقی نزد زوج ندارد	The wife has no right over her husband
استیفاء خسارات وارده	to compensate for/reimburse the incurred damages
وثیقه بانکی	collateral
سند صلح اموال غیر منقول	Immovable properties deed of conveyance
دارایی اعلام نشده	undeclared assets (properties) / undisclosed assets (properties)
برگ شماری پرونده	Profile/case filiation
حفظ بدل	Keeping the copy of the case
مشتکی عنهم	The defendants, accuseds
اداره پشتیبانی سیستمها و امور قراردادهای بیمه های اتومبیل	The office of automobile insurance regulations and system support
اداره صدور اشیا	vehicle insurance department
مبلغ 35% مسدودی	the blocked sum of 35%
بدهی استخراج نشده	Unsettled or unpaid debt
اگاهی نامه	Newsletter
کویرشناسی	Desert Studies
انجمن علمی مطالعات ساللمندی	Scientific Association of Aging Studies
وقت	Then
معاونت اجتماعی و پیشگیری از جرم قوه قضاییه	Deputy of Judiciary on Social and Crime Prevention Affairs
حق شغل	Position allowance/bonus
تفاوت تطبیق کلانشهرها	Metropolitan Discrepancy Adjustment
فوق العاده جذب هیئت امنا	Bonus of employment in the board of trustees
فوق‌العاده نشان‌های دولتی	State Awards and Decorations Bonus/Allowance
خرابی به سازه ها	Damage to structures/constructions
فوق العاده ایثارگری	(Military/Army) Veterans' bonus
تفاوت تطبیق	Adjusted difference
تعهد نامه صادراتی	Export letter of commitment/recognizance
حوالجات ارزی وارده	Submitted/delivered/given payment orders
پیش دریافت اعتبار اسنادی وارداتی	Advance payment on import letters of credit
ستاد تنظیم بازار	Market Regulatory Committee
بیمارستان سوانح سوختگی	burn center / burn unit / burns unit
بستن شاخه های پایین رونده عروق رحم	ligation of descending branches of uterine artery
ادم ریه	Pulmonary edema
مت هموگلوبینمی	Methemoglobinemia
ناکفایتی آدرنال	Adrenal insufficiency
ماده الحاقی به قانون ثبت	Appended Article / Article Appended to the Registration Law/Act
محل امضا دفتر یار دفتر خانه	(Place of) signature of notary public assistant
دانه های جامد زردفام مایل به خاکستری	grayish yellow granules
فراعمل گرایی	hyper-pragmatism/ultra-pragmatism
حاجب	court crier
مامور قرق	Cordoning officer
روسای ساخلوی نظامی	chiefs of the military garrison
ستاد توان‌افزایی	Empowerment headquarters
بنگاهی	Corporation/corporational
نهاده های درون زمین	underground resources
دفترچه چکیده معرفی کتاب‌ها	Booklet of Book Summaries/Abstracts/Overviews
جریان شناسی سلفی تکفیری	A Study of Salafist-Takfiri Current
تماس درزه	joint contact
در لغت	in the literal sense of the word
مقیدکننده	Restrainer
گری	Gray
حسابداری و کنترل های مالی دولتی	Governmental Accounting and Financial Control(s)
اصول و کلیات بیمه های اشخاص	Principles and Generalities / General Principles of Personal Insurance
آیین دادرسی کیفری	Code of Criminal Procedure
سیر انحطاطی تاریخ	deteriorating/degrading course of history
خطاهای فکری علم اقتصاد	Intellectual Errors of Economics
مقاله نویسی در مطبوعات	Media/Press Essay Writing
روش پرامیت	PROMETHEE method
مقیاس همسانی معنایی رزنیک	The Resnik's semantic similarity measure
همترازیابی	Alignment
چرخه تبرید جذب انرژی خورشیدی	cooling cycle of absorbing solar energy/ solar energy absorption cooling cycle
حقیقی و حقوقی	natural and legal
توسعه كمی و كیفی نیروهای متخصص،	qualitative and quantitative development of specialized force
مدل های استهلاک انرژی	energy dissipation models
کرسی آزاداندیشی و هم اندیشی	Free-thinking tribune and seminar
سیستم توزیع داخلی تلفیقی	internal distribution Compilation system
همایش مبادله تجارب خودگردانی انجمن ها	The Congress on Sharing Experiences of Associations' Self-regulation
فشار منفذی تعادل	pore pressure
اعسار به تقسیط	to be paid by installment due to insolvency
برهم اتصالی کوانتومی سیستم های دور دست	the quantom connections of remote systems
تفسیر چندجهانی	multi-universal interpretation
مغالطه ی ترکیب بندی	fallacy of composition
نقض پایستگی انرژی	violation of energy conservation
مکانیسم گسیختگی موضعی	Local faliure mechanism
مکانیسم اثر خمش عمودی	vertical bending effect mechanism
پول‌های سرگردان	Hot Money
منوی میانی	intermediary menu
فرایندهای فرانور	superluminal processes
قانون ضدناپذیری	The law of non-contradiction
سیگنال رویزيون	revision signal
بافت زمینه	initial tissue
کارکدک	Carcodek
تابلو فرمان	control panel
سند مالکیت حبسی	entailed deed
شناور مسافری	Passenger ship
شیر هواگیر	Bleed nipple
ماده ضد جوشخوردگی	Anti-seize compound
تصمیم گیری تحت شرایط عدم اطمینان	Decision-making under conditions of uncertainty
سر به سر	Break even
نسبت درآمد-هزینه	The Cost Revenue Ratio (CRR)
از لبه نیفتی پایین	Whatever you do, watch out not to fall down from the cliff's edge
انصراف	back out/withdraw
مصوبه	Approval
هیأت بررسی تخلفات	Violations Inspection Committee
آئین نامه	bylaw
کارشناسی ناپیوسته	student of non-continuous/ interrupted B.S course
مشارکت وابسته به افکار سازمان‌محور	collaboration pertains to organizational based thoughts
چهارچوب آموزش اجباری در قالب تأمین مالی	compulsary education in the frame of financing
مرده زایی	Stillbirth
تعداد ضربان قلب جنین	Fetal heart rate
فتوکپی برابر مدرک ابزاری می باشد	Duplicate/certified copy of submitted instruments
عالیترین نشان رعایت حقوق مصرف کنندگان	highest award for observing consumer rights
الزام متضرر به کاستن از میزان ضرر	the injured party obligation to mitigate the damage
حذف بدهی مشکوک الوصول از دفتر حساب	Writing off the doubtful debt from the register
قرار اجرای حکم دادگاه	writ of execution; writ of enforcement
جوجه را اخر پاییز میشمارند	Don't count your chickens before they hatch
کبریت بی خطر	wouldn't hurt a fly
طلاق رجعی	mutually revocable divorce
دست خط خرچنگ قورباغه	chicken scratch
عام المنفعه	of public utility/interest
نصب سیفون و فلاش تانکها	installation of siphons and flush tanks...
سر دوشها و شیرهایی که هوا داخل آب میکنند	aerating shower heads and taps/faucets
مصادیق حقوقی	Legal examples مصادیق حقوقی
سطل های بازیافت مجزا	Separate Recycling Containers
فرضيه گوش به زنگي-اجتناب	vigilance–avoidance theory
با دُمش گردو میشکاند	bouncing off the walls
شاخص عینی قابل مشاهده	Observable objective indicator
مگر در شرط خلاف	unless otherwise is agreed/provided
مشمولین	Draftee
خونریزی نسبتا فعال	relatively/half-active bleeding
سُر و مُر و گنده	fat, dumb, and happy
باز شدن اشتها	To whet the appetite
فرصت مطالعاتی	Sabbatical leave
یه روده ی راست توي شيكمش نيست	there's not an honest bone in his/her body
مشکلات ناشی از بازارگرایی	Problems stemming from market orientation
افزایش بی رویه آلاینده های کربنی	Irregular increase of carbon emissions
تخصص - فوق تخصص	Super-specialist// Sub-specialist
تجاری، اداری، مسکونی و آموزشی	Commercial, Administrative, Residential and Educational
مناقصه گزار و کارفرما	Client for both
بر روح و روان هر رهگذر تاثير می‌گذارد	Impresses the spirits of every passerby
مخمر آبجو	Brewer\'s yeast
ستاره اقبالش رو به افول گذاشت	His lucky star seemed to wane/to be on the wane
کبریت بیخطر	wouldn\'t hurt a fly
خاک میخوره	Gathering dust
چیزی را از چنگ کسی دراوردن	to pry something out of someone\'s fingers
آب خوش	enjoy oneself
پشتش لرزید	a chill went up his spine
چشم روشنی گفتن	used it as an excuse
چیزی سرش نمیشود	Pudding head/Soft-headed
در دلش میریخت	to keep one\'s emotions/feeling bottled up
نیش عقرب نه از ره کین است	a leopard cannot change its spots/ a tiger cannot change its stripes
رویش به روی دیگری باز شده	he had gone brazen-faced/barefaced to somebody
to see how .....can be....	پیش‌بینی نحوه تحقق اهداف سازمان ملل دشوار می‌نماید
گندش در نیآید	so that the shit doesn\'t hit the fan
آدم با چشم و رو	self-restrained
کسی را تنها گیر آوردن	corner, court
آسمان به زمین رفتن	The sky has not fallen
لجش گرفته	to get pissed off
توی بوق و کرنا کردن	with a lot of hoopla/hullabaloo
صابون کسی به تن خوردن	Do harm to/inflict harm on somebody
به سلامتی	Fortunately
مثل پروانه دورش می گشت	fluttered around her like a moth around a flame
آبرو را جلوی درو همسایه بردن	dishonor/throw a book at somebody before neighbors and passersby
آیین پذیرایی	hosting etiquette
یک من بودن	and they were both equally stubborn.
غیرتی شدن	feel one\'s (family) honor attacked
خودش را میگرفت	put on airs/ give oneself airs
از دهان در رفتن	Let sth slip
سبب کاهش قدرت سازگاری	Reduces their compatibility
سر صف	Morning rituals
فرد را مستعد افسردگی کند	makes the individual prone to depression.
از خواب غفلت بیدار شدن	ignorance leaves him, and he gets conscious
کمک‌های فردگرایانه و چندجانبه	Individual and collective assistance
جای دوری نرفته	has not gone anywhere
سطح پایین اقتصادی	low economic status
که این ارتباط بر حسب جنس	gender-based relationship
در طول مطالعه محرز شده	had been established/verified during the course of the study
معلوم الحال	Of ill-repute
طی مطالعات جهانی دریافتند	Through global studies they found/discovered/learned...
از حلقش بیرون میکشم	force / squeeze my house off his throat/make him cough up my house
افراد با تحصیلات دانشگاهی	People with higher education/ university education
با کدهای ویژه وارد نرم افزار	were fed into SPSS in the form of codes
فلان فلان شده	blankety-blank
مقیاس آن بر اساس 3 درجه نقطه‌ای	based on a 3-point scale
خون بدل کسی کردن	\be a thorn in somebody\'s flesh\
روش انجام تحقیق الف کتابخانه ای	Research A was conducted using a library research method.
از بین پیغمبرا جرجیس	Among the prophets, George was her destiny.
عدم ادامه تعقیب دعاوی	Suspension of prosecution of lawsuits
گواهی عدم افراز	Non-partition certificate
درمان دارویی-مشاوره ای	Medical-consultative treatment
مبلغ حق امتیاز	royalty
در مسیر حرکت آتی سازمان قابل پیاده سازی باشد	It would be realizable in organization future course
به عنوان زیرمجموعه هایی از مفهوم گسترده تر کارآفرینی پایدار عمل می کنند	...work as subsets of the broader concept of sustainable entrepreneurship
چه پیامدهایی در پی دارد	To what consequences it may lead
نبود شفافیت نسبت به جلوه های مختلف کارآفرینی	Clouded in opacities ...
تقسیم نامه	partition deed
نزدیک ترین واحد نیروی انتظامی حوزه استحفاظی	closest Local Law Enforcement unit
اخذ مجوز	obtaining a license/permission
مشخصات سجلی	identity details/particulars
عرصه و اعیانی	Building site and standing property
از رهن دراورد	redeem the property
مرگ خواهی و مرگ طلبی	Death wish
کادر فنی	coaching (or support) staff
تیم بسکتبال پایه	Youth/Junior Basketball Team
اهل ادا و اطوار	a poseur
انزوای خودساخته	self imposed isolation
شیر برداشت آبگیری تانکر	water tank drain valve
مابذل مهریه	Bestowed (Marriage) Portion
عقد انقطاعی	temporary marriage
فرا سازمانی	extra-organizational
عدم وضع مالیات	Not levying a tax/non-levying of a tax
تمام شمار	full enumeration/
هیات عالی نظارت بر سازمانهای صنفی کشور	Iranian Gild organizations\' Supreme Surveilance Board
دخیل بودن	to be involved
قانون مجازات قاچاق اسلحه و مهمات	The Smuggling of Weapons and Ammunition Act / Penal Code for Arms Brokering
سامانه فیش و احکام مستمری	Pay slip and pension certificate system
شماره دفتر تفضیلی	Enlistment detailed entry number
شماره دفتر اساس	Enlistment basic entry number
لیسانس وظیفه	(Military) Conscripts with bachelor\'s degree
گواهی عدم ابتلا به سل	Tuberculin skin test certification (for marriage license)
سامانه اجرائیات	The Executive System
اجرای وظایف محوله	fulfill assigned duties/ Perform Assigned Duties/ to carry out assigned duties
مکاتبات	correspondence
طی کردن مراحل ترقی	It went through the stages of evolution/development
واحد ابلاغ شماره ملی	national ID number issuing unit
اتهام انتسابی	attributed accusation or attributed charge
کاربری کامپیوتر	Using computers/computer use
معاف از رزم	Exempt from combat
کادر وظیفه بسیج	Baseej personnel
Ghaltak Static	static tandem roller
Sang Shekan	Crusher
غمگین تر از آواز میخواران شبگردم	sadder than the chant of a sleepless / nightwalking drunkard
هوا هوای سینما رفتنه	the weather is movie-going weather
دختری كه ميتونه از موهاش بگذره	A girl who can sacrifice / give up her hair (more lit., have her hair cut)
کوت کردن	To collect, pile up, heap up, increase, grow
زبان گویای محرومان	Eloquent voice for the oppressed
مدیر کل حوزه وزارتی	Director General of Ministerial Jurisdiction
كوه پشتمه	he has my back (he's my pillar of strength; lit. he stands behind me like a mountain)
سریارو	those who (یه سری ها رو)
نمک ریختن با چیزی	to make fun of someone, to poke fun at someone, to joke about something
در جریان ... بودن	to be aware of ...
علاقه به یه تیمی بودن	to be a fan of a certain team, to support a team
جمنا	Popular Front of Islamic Revolution Forces
بنا به اقراره	written admission/affidavit/declaration
مصالح و متصالح	grantor and and grantee
نگران بچه بيراموند است	is worried / concerned about Beyranvand's kid
ضریب پیمان	contractor\'s (price) coefficient
پردازش خط مستقیم بر داده ها	straight line data processing
قدرالحصه از عرصه	the related portion of the land lot
تنوع طلب	Changeable/ fickle / inconstant
دور از ذهن	unimaginable; unthinkable; inconceivable; unconceived
تبصره ذیل ماده 41	note under article 41
گر به من دست بزنی، دستتو زود پس میزنی	You touch me, and you'll touch off soon (lit., Touch me and your hand will quickly recoil)
پیشرفتگی به فضای خیابان	protrusion into the street
نظام ارجاع	referral system
صفحه مارّ بر نقطه	the plane passing through the point
Country Procurement Manual ?	راهنمای تدارکات کشور(ی)
ما که می دونیم نیست	(It's enough that) We know it's not so.
همچنان بلاتکلیف	still unresolved, still in limbo
جاری شرکا	partner current account
خدماتی	service, service-related
زبره	Swarf
واحد مواد سازی	material fabrication unit
کلیشه چاپ	Printing plate
قالب مادر	mother mold
واگن چینی	wagon/hopper/car loading
ترانسفرکار کوره	transfer car/hopper
سانتی‌بار	centibar (cb)
سفیدکاری	plastering
بیمه کردن	to insure
رسمی	permanent (employment)
تنگ گرفته است به بر	has embraced tightly, has encircled tightly
دریافت کردن طی فیش	receive against receipt
معادل با	equal to
پایداری شیروانی	gable proof stability
نفت گریزی	oleophobicity/Lipophobicity
آزمون‌های آزمایشی	practice tests - prep tests
راز، سر خواهد رفت	the secret will brim over / overflow (be revealed)
اوصاف زمين	earth's howabouts
خانم های قری	coquettish, mincing, cheeky women (from قر دادن, hip-swiveling or dancing)
من یه چیزی هارد مانند، برداشتم	I took something like an external hard drive
یک لات بامرام	a punk / hooligan with principles
سند اقرار نامه غیرمالیاتی	Non-tax declaration document
آدما ب کسایی ک دوستدارن و میخوانشون نمیرسن	people cannot have the person they want (love)
سر بکش بره	Just gulp it down! Just drink it!
در شرار آتش دردی نهانی	in the flaming / blazing sparks of a hidden pain
کاش چون پاییز خاموش و ملال انگیز بودم	I wish I were silent and vapid, just like autumn
نیمه گمشده مو	soulmate, partner, lost half
دشمنت شرمنده	no worries, never mind
وزیر یک دنده	the stubborn minister
دستم به دامنت	I beg you to help me!
اینجا واسه فاطی تمبون نمیشه	Staying here is pointless / won't do me any good!
بابا آدم با نخریدن هاست که خوشحاله اون حال خوبی که با خرج کردن پول میاد میخوام صدسال سیاه نیاد	If I'm supposed to find happiness in spending money, I'd rather never be happy!
طهر غیر مواقعه	unpunctuated woman while in pureness state
وکیل مستقیم	lawyer
وکیل مع الواسط	mediator-attorney
اﻟﺤﺎﮐﻢ وﻟﯽ اﻟﻤﻤﺘﻨﻊ	Haakem Rule
قلق گیری	calibraton
موافق	same direction
پیچ و انحنا	bends and curves
رفت و برگشت	roundtrip
عشرت پروانه را شمع و لگن واجبست	Nothing can provide the butterfly with festivity except a candle and a basin
پرملات	rich, full-bodied
کسی را تحویل نگرفتن	to give someone the cold shoulder, to snub someone
شق ورق نشستن	to sit up straight (as stiff as a poker)
...ابری هم كه باشی	even if you're feeling blue...
استعفا به احترام علما	resign out of respect for the clergymen / scholars
به پل زدن حریف	to put one's opponent backward into a bridging position; to put one's opponent on their back
باطل شدن (تمبر)	invalidate/nullify
وعده سر خرمن	an empty or hollow promise, to promise someone the moon / earth
داداش گلم	(My) Dear bro
یه تنه گند زد به	he fucked up Persepolis all by himself; he spoiled everything for Persepolis single-handedly
آب‌ هبیج بخور بلکم (بلكه هم) با این فرمونی که پیش گرفتی کور نشی	have some carrot juice so maybe you won't go blind with the lifestyle you've adopted
آچمز کردن	to pin (a chess piece)
طرح دوستی ریختن	to make friends or strike up a friendship with someone
عشق کسی کشیدن	to feel like doing something, to like / love to do something, to have a whim to do something
(کی خستس؟ (چه کسی خسته است؟	Who's tired?
پسر فال فروش	kid / boy selling horoscopes and fortune-telling notes
ناوگان	fleet
مقرین	deponent/affiant
گر ذوق نیست تو را، کژ طبع جانوری	If you can't be cheered up (by listening to music), then you are as dumb as (no better than) an animal
الکی عیب روش نذار	don't go looking for faults with it, don't nitpick
واقعن تعجب می‌کنم از اینایی که از آدما انتظار دارن، از حیوونا باز یه چیزی	I'm really amazed by those who expect things from people. Expecting things from animals seems more reasonable
پرس ناهار	lunch portion, lunch helping
خیر مقدم عرض می نماییم	We would like to express our warmest welcome to you
باطری کش کردن	to pull out the battery, to disconnect the battery
... مورد داشتیم که	there was this one time that ... ; once there was a ...
سازشناسی	Organology
حرفه‌ای‌تر دنبال کردن (موسیقی)	pursue professionally
طرفدار دوآتیشه	diehard fan, hardcore fan
استفساریه	screening, assessment (more lit. inquiry)
fine-tuning	میزان سازی دقیق
versatility	همه فن حریفی- چندکارگی
شاخ و شونه کشیدن	To intimidate, to bully, to bluster
کیمخت خارپشت	hedgehog's skin
جلاب	rosewater (گلاب)
شمعی به پيش روی تو گفتم كه بركنم	A candle that I said I'm going to (I intended to) light in your presence
عشق و حالتو کردی	you had lots of fun / enjoyed yourself, you've sown your wild oats
مشرح به مقررات نفسه	as defined by the provisions per se
!زنبیل بذارم؟	Am I supposed to leave my shopping basket there (in order to keep my place in the line)?!
در معیت	in... company/ along with/ with/ together with
الاف شدن	to keep waiting for someone
مخ زدن	to hit on someone, to chat someone up, to sweet talk someone
جملات قصار	aphorisms, bon mots
In ghadr laf nazan	Don't shoot off your mouth for me, don't show off
Har lahaze momkene dard biad soraghesh	She may begin to feel pain at any moment
باری علاج شكر گریبان دریدن است	However, the treatment for thanking is nothing but the tearing of the collar
سرموضع بودند	they kept their previous stance
ریاضی جبرانی	Remedial Mathematics
مجری طرح	Line producer
حساب درآمدهای اختصاصی صندوق	the fund\'s special revenue account
دو میل	two millimeters
قشر مورد تنفرم	the kind or type of people I hate
البته به جا باشه	when appropriate / deserved (when carried out fairly), of course
Trending Courses	دوره های مورد استقبال یا پرطرفدار (فعلی)
ماله کشی کردن	to whitewash, to cover-up
موج گرفتگی	blast injury
برابر رای صادره	Based on / according to the verdict issued
دیش دن دیش دن	Ra da da da da (onomatopoeia for music playing, dancing, and people being happy)
شلنگ تخته انداختن	frolic; paddle; lope
تطبیق	adjustment/verification
تا چششون دراد	To show them! To spite them!
کراشی	A crush
بدون خط‌خوردگی و خدشه	without any strikethrough or alteration
مصوبات شورای عالی برنامه ریزی علوم پزشکی	The regulations of the Supreme Council of Planning in Medical Sciences
خدا کرد تو چشمم	God made my words inverse!
دم بخت	marriageable
قربون صدقه کسی رفتن	to address someone very lovingly, affectionately, or intimately; to flirt (e.g., saying I would die for you)
تازه اولاشه تلفات واسه وسطاشه	it's just the beginning, losses are yet to come
پیش قاضی و ملق بازی	You can't teach grandma to suck eggs
مراسم لعن	the cursing ritual (traditionally performed by some Shiites during which Omar, a prominent figure in the early history of Sunni Islam, is cursed)
لاله ها و آلاله ها	young, cherished martyrs (lit. tulips and buttercups)
هشدار سربسته	veiled warning
سر از پا نشناختن	heart and soul (to be so enthusiastic about or committed to something that one forgets about themselves)
دوران بزن‌ و در رو	the era of hit-and-run
داماد لرستان	Lorestan's groom (Seyed Mir-Hossein Mousavi)
پرکن و بخور	buffet / self-service
جوون مرگ	dying in youth, one who dies young
Ammar dare in khak	this land has faithful men (like Ammar)
زوج و فرد	even and odd
تالی تلو امام	the Imam's follower or successor
بازمانده دیگ ساینده سیاست ایرانی	a survivor in the abrasive cauldron of Iranian politics
وقتى پلو را آوردند سر سفره نشستند	they took advantage of the situation
نقش بر آب کردن	to foil or ruin a plot
همشیره	sister
بستگی به پلک رهبر دارد ...	... subject to the Supreme Leader's slightest wish; at his beck and call (lit. waiting on a blink from the Supreme Leader)
فیش دوم	second paycheck
خداوند روزی را در کاسه ما گذاشت	and God gave us the day; God gave us the winning hand
لجنزار اباحیگری	morass of moral nihilism
چوب لای چرخ کسی گذاشتن	to throw a wrench in the works
دﻫﯿﺎري	rural municipality
رای گیری توسط گلدان	Casting votes using a vase as a ballot box
الحشد الشعبی	Popular Mobilization Forces
هشت ریشتری	epic, world-shaking, shocking (lit. an eight on the Richter scale)
مثل خر تو گل گیر کردن	to fall down on the job; to be stuck with no other choice (lit. to be stuck like a donkey in the mud)
کلید قلابی	false key
عمله و اکله	servants, lackeys, flunkeys
اعلامیه های بین راهی	memorandum in transit
بین المجالس	inter-parliamentary
جواب سربالا	vague, evasive, prevaricating answer
این کار از روی ... بود	this was done out of ...
برق خوانده	he had studied electrical engineering
تلخند	smirk, wry or bitter smile
زاویه داران با رهبری	those who deviate from the Supreme Leader
بیلاخ بزرگ	A big middle finger
سر بی كلاه	empty-handed
عیان و رویه	obvious and routine
از درون دست تو می کشد کمان	You draw my bowstring from within (Your love is killing me from within; you are haunting me)
گوش فلک را كر کردن	to make a great fuss over something, to lay it on thick
آش اينقدر شور شده كه خان هم فهميد	the situation has gotten so bad that everyone knows about it (lit. the stew is so salty that even the master knows it)
آدم را دق کش کردن	to give someone a really hard time, to give someone a lot of grief
دست انداختن	to make fun of someone, to tease someone, to pull someone's leg
نمک نشناس	ungrateful, ingrate
عزت زیاد	gotta go, have a good one!
ناز شصتت	good for you, more power to you
هیزی	lecherous
داوطلب آزاد واحد آموزشی	Free applicant of the education institue/unit
اگر شب و روز یکی شد	When pigs fly (lit. if day and night become one)
با لحن داش مشتی	in a hoodlum tone
بن کارت	co-pay card, voucher, token, coupon
خفتن	to slumber (literary word for sleep)
سخنان واجد وصف مجرمانه	statements that qualify as a crime
cross tension member	قطعه کششی
هوس	temptation, craving, terrible desire
بدیش این بود که	the devil of it was that, the thing of it was that
خيلی ها تاب تحمل پرسش و انتقاد را ندارند	many can't tolerate questions and criticism; many are not open to questions and criticism
ذریه طاهره	virtuous offspring or progeny (lit. seed)
امم دیگر	other nations or peoples
پیر شدیم رفت آقا	Man, I'm already over the hill
واژه را عيناً آوردن	to use exactly the same word, to leave the word unchanged
(grade) اخذ گرید	being graded, obtain grade/ranking
casting direction	جهت بتن ریزی
طبقات مرفه	the upper class
توپ را در زمين ديگران انداختن	To pass the buck
منت	favor, obligation, indebtedness
جمع منفرد	singular collective (gathered together but alone)
جام جمشید	Cup of Jamshid
liquid-assisted grinding	آسیاب کردن به کمک مایعات
solvent-free assembly	تجمع/ترکیب فاقد حلال
تا كى از خودت هيچی ندارى؟	When are you going to have something of your own?
تفاضل گل	goal difference, goal average
برای آنها در بر همان پاشنه می چرخد	the situation won't change for them
مقابله به مثل نسبت به	retaliate against, reciprocate, counterattack
یارانه های اهدایی داخلی	government subsidies
ریل گذاری	laying down railroad tracks
دادگاه صالحه	competent court, court of competent jurisdiction
برتری نظامی	military superiority
عوضش کیف داد	but it was fun
الهی بگردم	my darling, sweetie, sweetheart
کی میشه توام بری سر خونه زندگیت	When are you going to settle down (get married, have a job, etc.)
ته زمین پدریمون	at the end of our paternal land(s)
دیو آشیان	demon's nest, devil's nest
شبیه زنا شدن	to become like the women, to look like women
پاره ای مشکلات	some problems, a couple of problems
attendant	به همراه
coupled IP activity	فعالیت آی پی جفت شده
job submission	واگذاری کارها
Shiny	افراد باحال/معرکه/محشر
Shift loadings	هزینه مازاد شیفت کاری
log-distance path loss models	مدل های از دست دادن مسیر در ارتباطات راه دور
واجد شرایط تک ماده	safety net-eligible students
نا مقید	Unconstrained
حجم	a solid body; a form
حزن آلودی	sad, mournful, grief-stricken
نی نی چشم	eye pupil
کینه مردم ایران مثل کینه شتر است	the Iranian people hold long-lasting grudges (lit. the Iranian people's grudges are like those of the camel)
...دهن حسین صاف شد	Hussein came through hell and high water to...
kalafe kardan kasi	to annoy or irritate someone, to drive someone up the wall, to get in someone's hair
کلپچ زدن	to eat kaleh pache (a popular Iranian breakfast dish consisting of the boiled feet and head of a cow or sheep)
گشنه	hungry
همو کردن	to do each other, to fuck, to have sex
زير انداز	picnic blanket, mat, spread
حمال	low-class, jerk, bitch, slut
آذين بستن	to decorate, ornament, or embellish something
جوارحشان	organs
كار دست خودش ميده	get oneself into trouble, harm oneself
Zarar ke nadare	It can't hurt; it's worth a try
طمع کردن	To covet, to greed
Chendesh ha!	Disgusting!
تریپ فردین بازی درآوردن	to act generously (lit. to act like Fardin, an Iranian actor who played roles in which he always tried to help others even if it got himself into trouble)
Life goes not backward nor tarries with yesterday	زندگی به عقب باز نخواهد گشت و نیز درجا هم نمی زند
رب	paste or sauce (e.g., tomato, pomegranate)
میزه مزه	tasting table, table of appetizers
دوا درمون	medical treatment
من مرده شما زنده	I bet, I swear (more lit. I know something you don't)
Bayad ez sobh ta shab hezar jur zakhmat bekeshi ta yeh loghme nun peyda koni	You have to work all the time just to make a living (lit. to get a piece of bread)
siasyun	politicians
خونه رو سابیدیم	we scrubbed the house
فی الحال	Currently, for now, for the time being
بوج بوج	kiss kiss
گونه هایش به سرخی می گرایید	his cheeks were turning red
نفس زنان	all out of breath, huffing and puffing
من مقصودی ندارم	I don't mean to be rude; I mean no harm
لحظه تحویل سال	the instant the New Year begins
خایه مال	Brown-noser, ass-kisser, bootlicker, suck-up
جيش دارم	I gotta pee
seeding a partial stream	تأمین جریان نسبی
جفتشو پیچوندم	I ditched both of them; I turned them both down
یه کم دیشتو بخوابونی	tilt your satellite dish down a little bit
فرودگوهی	someone who works in an airport (in Kashani accent)
جایی که منجلاب گه است دم از اصلاح زدن خیانت است	Where the cesspool is full of shit, talk of improvement is treacherous
ترشیده	spinster, old maid
لاکتاب	ungodly, implacable, miscreant
یقه معلم بینوا را مى چسبند	grab the poor teacher by the collar, put the blame on the poor teacher
جقی	wanker, masturbator
ﯾﻪ ﭼﺸﻤﮏ ﺑﻬﺶ ﺯﺩﻡ	I winked at him
عینکمو دادم پایین	l lowered my glasses
mayus shodand	they were disappointed
سهامی خاص	private joint stock
الحاقیه قرارداد	addendum to contract
ستاد مبارزه با مفاسد اقتصادی	Anti-Economic Corruption Headquarters/Center
ببین تفاوت ره کز کجاست تا به کجا	look how great the difference is between the two ways; it is from where to whence
پشمام سوخت	I was stunned; I was shocked; I froze
ممه فریال	Feryal's boob, Feryal's tit
تقى به توقى مى خوره	as soon as something trivial or unimportant happens, at the drop of a hat
چوب تر	severe or strict punishment; not sparing the rod (lit. a wet stick)
مسائل جزئی و خرد شهری	minor urban issues, trivial urban issues
منبر سه پله	three-step pulpit
خودروی صفر	a brand-new car; a car with zero miles on the odometer
رشته ای بر گردنم افکنده دوست؛ می کشد هر جا که خاطر خواه اوست	The Friend (God) has tied a rope around my neck, and He pulls it wherever He wants
از سیر تا پیاز	from A to Z, from soup to nuts, everything about ...
هان بیکاری؟	What? Don't you have anything else to do?
پیله نکن	don't pester me; stop it
گوش شیطان کر	knock on wood (used to prevent the evil eye)
شتر در خواب بیند پنبه دانه	you wish, when pigs fly (the cat dreams of mice, lit. a camel dreams of cottonseed)
مرده شور جفتشون رو ببره	damn both of them
صعب روزی بوالعجب کاری پریشان عالمی	such tough times in which strange phenomena occur and pain and suffering spread everywhere
خاطی ندارد	it doesn't matter, it makes no difference
مگه کشکه	Is it so easy?! Nonsense!
کش	rubber band
گولم میزد	would have tricked me
رنج حقوقی	salary range
؟ رانت	Economic rent
حیله شرعی	Legal ruse
گوارا باشد بر شما که آرامش دارید	enjoy this peace (may this peace be pleasant to you)
قلم	pen
سطر	line
حرا	Hira (a cave near Mecca where Muhammad first received revelation from God through the angel Gabriel)
الفت	fondness, affection, friendship, intimacy
نیروهای دست اولشان	their first-rate, elite, frontline forces
نگرش حذفي ?	elimination-based attitude
رواله	It's cool
آره اوکیه	Yeah, it's OK
رأفت	kindness, compassion, affection
به مرور زمان	with the passing of time, gradually
نوشدارو بعد از مرگ سهراب	the damage is done; it's too late (after death, the doctor)
...نقش	is like...
پاى بند	foundation
Harke ro tavus khahad, jur-e hendustan keshad	He that would have fruit must climb the tree
اخه صدات مگه به جایی هم ميرسه؟	Will your voice even be heard?
نقش خود را به رخ جامعه بکشند	flaunt their role in society's face
ما بی‌زمان شده‌ایم	we have lost the sense of time
دم اسبی	ponytail
دعا نویس	writer of amulets and prayers
قائم	the agent of the righteous; the establisher of justice; the Self-Subsisting (the Hidden Imam)
نفس زکیه	pure soul
مسلمانان را به گرد خود می آورد	to gather / bring together Muslims
رفع حاجت	bowel movement
نمازهایم قضا شده است	I've lost the chance to say my prayers
علاقه وافری	great interest, enthusiasm
معمم	turbaned, belonging to the Muslim clergy
کد طلبگی	seminary student ID number or code
با یه من عسل هم نمیشه خوردش	he's not such a friendly guy (lit. you couldn't get him down with a bucket of honey)
جزوه	lecture notes
خروش از خم چرخ چاچی بخاست	the bow and arrow made a very loud noise
خونه ای ایلاتی از اییلاق تا قشلاقه.	Tribesman's house extends from his summer- to his winter quarter
اقامه نماز کردن	to lead the prayer, to hold prayers
نثار کردن	to present something, to bestow upon
طرح‌های آبرسانی	irrigation / water supply plans
he had worked on him, he had buttered him up	مخش رو کار گرفته بود
هله هولهٔ	junk food
رفاه نسبى	relative well-being
گومبول	chubby (fat in a pleasant and attractive way)
نینی	baby, babe
دو هیچ به نفع احمدی‌نژاد	two-nothing (score) for Ahmadinejad
هی رد میشدن	kept passing by
چیزی باب میل شما پیش نمی رود	something doesn't go the way you want, something doesn't go your way
لاک دفاعی	protective shell
درست درمون	expert, seasoned, veteran, pro
اونوخ	while, whereas
رییسم فرو کرده بود که کار داریم	my boss insisted that we have something to be done
از دوری کسی ناراحتید	you are unhappy because someone is far away
مطالعات تطبیقی	comparative studies
چشم غره رفت	glared
از هم نپاشیدن هنره	not falling apart / not being demoralized is an art
زلم زیمبوی	tawdry jewelry, old and cheap jewelry
دون پاشیدن	to trick or deceive someone (lit. to scatter seeds around)
لامصب	(Indicates disbelief in what has just been said)
راننده سرویسم	my shuttle service driver
زدن برجک آیت‌الله منتظری	undermining Ayatollah Montazeri's position
دستش به دهنش می رسد	he is well-off / affluent; he is not in need
فی نفسه	inherently, in and of itself, per se
سنوات	years (of military or other service that qualifies someone for benefits or severance), seniority
نیایش و ادبیات نیایشی	invocation and devotional literature
گرایش مدیریت و برنامه ریزی آموزشی	specialising in management and curriculum planning
مینالن	complain, grumble, bitch
نور به قبرش	may God bless him (lit. may light shine on his grave)
میکنه تو خودش	keeps it all inside, keeps it bottled up, keeps it to himself
آلام	Pains, afflictions
پشم و پیل ریختن	to get old and gray (lit. to lose one's hair)
پر و پاچه	legs
مهره‌ ها	game pieces (e.g., chess or backgammon)
نان ناشتای	breakfast
سینه قبر	the middle of a graveyard / cemetery
خط و خبری از آنها پیدا نشود	there is no sign or trace of them
Be delam barat shode...	Something tells me that...
بی هوا	suddenly, unexpectedly, carelessly
تناس بر لبها می بندد	the mouth closes itself to the lips (the mouth isn't willing to utter words anymore)
چمبر شدن	to curl up, to squat
در دستور کار قرار گرفتن	be put on the agenda
همسو کردن	aligning ... with ...
حاکم	Governing
دستت رو شده	You've given yourself away; I can see through you now; you've shown your cards
یه بام و دو هوا	Double standard
تا خرتناق خوابیدم	I way overslept
کارایی	efficiency
مقامات اصلی	main authorities
بررسی	analyzed/analysis/examined
دریافت	received/ collected/ reception
حوزه فعالیت	field/area of activity
دم کنی	rice steamer cover
دعای کدام مادر مستجاب خواهد شد؟	Which mother's prayer will be answered?
نمک	Humor, jokes, one-liners
یه عالمه	many, a lot, a ton
همش زیر سر توئه	you are the cause of all this; it's all your fault; you are responsible for this
slack-based measure	ﻧﺪﺍﺯﻩ ﮔﯿﺮﯼ ﻣﺒﺘﻨﯽ ﺑﺮ ﻣﺘﻐﯿﺮﻫﺎﯼ ﮐﻤﮑﯽ
منحرف شدن	deviating from
event windows	پنجرۀ رویداد
proxies	وكالت‌نامه‌/وكالت‌نامه‌ى رأی
رسالت	mission
salt-assisted	به کمک نمک
دوستدار طبیعت	nature-lover, environmentalist
مصرف پایه	minimum consumption
ماتریس جذابیت-توانمندی	attractiveness-capability matrix
بر لب جوب	beside the stream, by the stream, at the bank of the stream
ديوصا	Bastards, jackasses, SOBs (lit. cuckolds; nerveless, effeminate men)
تا به جد ننه بابات نرسونن ول نميكنن	until they tell everybody and his cousin/uncle (lit. your great-grandfather)
به ى عدل يونجه	For nothing (lit. a bale of alfalfa)
جهت ساز	guiding
iodide-promoted	غنی‌شده با یدید (آنیون ید)
ما را كه تو منظورى، خاطر نرود جايى	as long as you're in my mind / heart, I can't think of anything else
عابر بانک	ATM
havas parti	distractedness, absent-mindedness, being scatterbrained
chachaheh	chattering
Sar o kale	Evidence of, traces of
Vamunde	Low-life, loser, good-for-nothing, scum
ba una jik o buk dare	he's connected or associated with them (cheek-to-cheek)
کون	ass, asshole
مرحله پيش توسعه	pre-development stage
تعرفه هاي گمركي	customs tariffs
پاداش	discount
to go to completion	کامل شدن فرایندِ
حالیش نیست	doesn't know what's what, doesn't know the first thing about something, clueless
والله علی کل شئ علیم	And Allah is Knowing of all things
ادا اطواری	stuck-up, moody, fussy, prissy (high-maintenance)
جهت دهي	Giving direction
نظام نامه	bylaw
بانک اطلاعاتی	Database/ information bank
ageh pa dad	if the situation demands it; if it so happens
راهبرد کلان	grand strategy
دستیابی به	attaining (positions)
سند چشم انداز	vision plan
تا با....	so that they may/can....
جمله اخلال	error term
داداش	Brother, bro
کف و خون بالا آوردم	I was shocked; I felt sick to my stomach (more lit., I threw up blood and bile)
احمق فرض شدن	to be taken for a fool, to be regarded as a fool
کاشف به عمل اومد	It turned out that
نمیشه روشون حساب کرد	you can't count on them; you can't rely on them
Khasis bazi dar nayar	Don't be so stingy, don't be such a scrooge
Tizhoosh	School for gifted students
در مقاطع	level
Patil	Blind drunk, piss drunk, blitzed
برآورد الگوی تجربی رشد اقتصادی ایران	Estimation of/estimating the empirical pattern of Iran's economic growth
ورود به عرصه تجارت الکترونیکی	(one\'s) entry into e-commerce
تنگ میکنم	I get my ass in gear, I fasten my belt, I put my back into it
بپيچ ميبرم	wrap it / box it, to go
بگا رفت	fucked up
گولاخ	humongous, giant
اول رابطتون	At the beginning of your relationship
نفيثه	Nafiseh (a proper name)
ممرضا	Mohammad Reza (a proper name)
عقده ای	crazy, demented, frustrated, obsessed
میخوای حالیت نیس	you want it, you just don't realize it
اشتغال زایی	job creation
اساس	basis, foundation
ریدم تو این سرعت اینترنت	fuck this internet speed, shit on this internet speed
رهسپارم به سویت	I am heading toward you
چش بود؟	What was wrong with him? What was his problem?
هيكل	physique, build, body
كچلا	bald person
مرد جنگی سواره نظام	cavalryman; a competent or capable man
پایا	Automated Clearing House, or ACH (سامانه اتاق پایاپای الکترونیک)
خداوکیلی	swear to God, honest to God (more lit., God as my witness)
كسی به من سر نميزند نیست	no one drops by, no one visits me
اما نه به نرمی تو	But not as leniently or complacently as you do
کن فیکون شده	finished, ruined, destroyed, wiped-out
داره زر زر میکنه	babbling, talking gibberish
بالای حکم کسی حرف زدن	to disobey, ignore, violate, or countermand someone's order
خودش را کنف کرده	embarrassed himself
نک و نالی	Whining, moaning, complaining
دنگ گرفتن	To feel like doing something; to take a fancy to doing something; to have a tendency to do something
لایه نشانی	Deposition
ماده توده	bulk material
باری به هر جهت	Scattershot, perfunctory, cursory, haphazard
سایت گردشگری	tourism sites=locations
نره خر	jackass, a fool or stupid person, a big, uncouth man
اشکم دم مشکمه	I'm on the verge of tears
سیاست جنایی افتراقی	differential criminal policy
بالادستی	high level documents
!زرشک	Humph! What a thought!
بلغور شعريات	talking nonsense, cock and bull story
اسفند برشته	burned seeds of the wild rue (esfand), a wild plant burned in order to ward off evil spirits in Iran
بر پایکوب نعل بلا گریه می کند	crying over the downtrodden under the iron heel of calamity
خط پیر جماران	the ideology of the Old Man of Jamaran (Imam Khomeini; Jamaran is the street where he lived in Tehran)
محمل	camel litter, palanquin
خاک کرب و بلا	the land of affliction and calamity (Karbala)
در کرانه بلا	on the edge (lit. coast) of disaster
بی تابی امانم را گرفته	restlessness overtook my security
history of individual Iranian ethnic communities	تاریخ تک تک/منحصرفرد جوامع قومی ایرانی
پدافند غیرعامل	Passive Defense
نسبتامون رو مرور میکنیم	we go over our relationships
دلم هری ریخت پایین	my heart sank
خیال میکنی راش میدادن؟	Do you think they would let him in (accept him)?
زوج درستی هستیم	we are a well-matched couple
نیشکر درو میکنه	harvests sugarcane (hacks down sugarcane with a knife)
تو دست و بالمون	at hand, available
کاسب چکو میکشه و درمیره	A merchant writes a check and then disappears
توروخدا	For God's sake
Khialet takht	Rest assured
موی چتری	bowl-cut hair (bangs)
سر به نیست کردن	to disappear (from the face of the earth), to fizzle out
يه سازی ميزده	would play an instrument
آهنگ ... از نوع دنيا ميخوام پياده شمه	it's the kind of I want to get off the world ... song
گیر دادن به کسی	to have a problem with someone; to have a bone to pick with someone
شاخ	excellent, good, correct
به در	tit-for-tat
نیم فاصله	half-space, zero-width space (e.g., in گل‌ها)
بگو کاری بکن، اگر نکردم	Tell me to do something, do it, I would; or, Tell me to do something, do it, I will
Ayn-e hulu	Beautiful, good, interesting (a real peach)
گوتو بخور	mind your own business; don't butt in
pa suz (kasi) budan	to be love-stricken (with someone), to be madly in love (with someone)
بچه دومی بودیم که مرد بار اومدیم	Being the second child made men out of us (caused us to grow up like men)
ماحمیت	Mahmit (a proper name)
حکم زنا داره	it's considered like committing adultery
گاز اول	the first bite
گفتن نداره	It goes without saying, better not to say it
Jun bekan	Put your back into it, shake a leg
Amrika khavaremianeh ro ez kaf dade ast	America has lost its grip on the Middle East
Juje halite?	Got it, punk?
باغت آباد شه انگوری	Grape growers, may your vineyards be prosperous (with these lovely grapes)! Or, May you be prosperous!
Hesabi oftadi tu zahmat ha	That's too much trouble for you; you've gone to a lot of trouble
Ahl-e bakhieh	An insider, someone who is knowledgeable / well-versed in a particular area; or a junkie, drug addict
Asl-e mojera ro beriz ruye dayere	Get straight to the point, don't beat around the bush, spit it out
صورتحسابگیری	billing/invoicing
eynohu simorgh mi resam	I'll be there in an instant (like the sudden appearance of the Simorgh in the Shahnameh)
rast o pust kande begu	say it straight out and barefaced (lit. with the skin pulled off)
asl-e kari	the main thing or item
بسوزه عاشقی قسم	swear by the burning heat / pain of love
لیموی پرآبی که می مکی	a juicy lemon that you suck
بازش یابی	regain it, recover it
مرگ را به دست سوده ام	I have touched death with my hands
خريدار ندارد	has no buyers or takers
جاى او خاليه	His absence is felt; He is missed (here); I wish he was here
به زعم من	in my opinion
آدم درست حسابی	decent, respectable, stand-up guy or person
خيلى نزنيد تو سر مال	don't talk down to or belittle me (don't criticize the merchandise so much)
ثنای حق	praise of the Almighty
دکه	kiosk
صدرنشین	front-runner
Che gonah karde pa suz-e man bashe?	What has he done to deserve being madly in love with me?
Cheshmet roshan	Congratulations; I'm glad to hear that
یک مشت سگ داعشی ریختند	a bunch of Da'eshi dogs spread out
ایول	Way to go! Right on! Nice move! (ای ولله)
منسجم	integrated
کندوی عسل	honey, sweetheart (lit. honeybee hive)
دستمایه شوخی	an object of ridicule
ماکت	Mock-up, model, replica
کلان	macro-level
جهت گیری	orientation
پروژه ای	project
اجرایی	executive
به تخمم	I don't give a rat's ass; I don't give a flying fuck
خارخارک	kharkharak (a brand of body scrubbing brush)
کار و مکافات	toil and trouble
با کسی قهره	isn't talking with or is avoiding someone (because they've been offended)
اسباب کشی	moving (to a new house/home)
تودماغی	nasally, nasal twang (lit. through the nose)
پتانسیل سنجی	Potential analysis
مشخصه یابی	Characterizing
افق	horizon
داده برداری	Data collection / gathering
be omid-e didar	hope to see you, see you soon, so long
فیو	fave (short for favorite)
تخمک	ovum/ovule
با بدان یار گشت	became a friend of bad people, associated with bad people
یه دور	once, one time
one’s own identity	هویت اصلی فرد
در راستای	in accordance with
دزدی با چراغ آمده	An old hand burglar, a dab hand burglar
آمریکا را بزک می کنند	make America look good, whitewash America
dast balaye daste man	the shoe is on the other foot, the biter is bitten, someone else has the upper hand
eshghe to ez ro havase	your love is just a whim
Yeki dige	Someone else, another person
Kham be abrut nemiamad	You didn't bat an eyelid
شما از رو نمیرید	you are as bold as brass
دست اندرکاران	Those involved
... ez sararoush mibare (از سرو روش می باره ...)	he just oozes ...
Elahi man duresh begardam (الهی من دورش بگردم)	I adore him so much, I love him so much, I feel so proud of him (lit., “God willing I will worship him”)
Be karetun beresid	Go back to work; go back to what you were doing
sarvar	boss, leader, lord, master (someone highly-respected)
gandi	screw-up, mess-up
نائب گرفتن	to have a substitute perform the Hajj by proxy
غربال کردن	to sort out, to screen, to winnow out, to separate
دفتر و دستک	notebooks and ledgers
منشن	mention
متولی	the performing authority
در همین راستا	Accordingly
درون زا	Endogenous
زرت زرت	Again and again, constantly, continuously
Migam nare, migi bedush	You can pull and pull, but you can't milk a bull
میاد قلنجمو میشکونه	he comes and cracks my joints
سمتم نیا کلن	don't come over to me at all, leave me alone
صورتت گارد داره	You seem intimidating
Deki!	Hooey!
Jadow o janbal	Black magic
kam kam degh kard o mord	he slowly died of a broken heart
Monshayt	Your secretary
دو قورت و نیمتم باقیه	(Used to describe someone who expects much more than they are due under the circumstances)
Daghoun kardan	To break, to ruin, to destroy
ظرفیت سازی	Capacity building
خدا آدمو محتاج هیچ کس نکنه حتی خودش	May God not make any person dependent on another, not even on himself
روکار	above-ground
دریا کردن دل	to be generous, big-hearted
سوتی	goof, silly mistake
دو قرون	two cents
بدبخت سه عالم	extremely miserable (lit. miserable in three worlds - donya, borzakh, and akharet)
بند گیسو وا کردن	to let one's hair down (lit. to untie / undo your hair)
يه چيزی بذار بيارزه	upload something worth watching
تاکسی دربست	private/non-shared taxi
خوش به حالش	good for him, lucky for him
به قصد کشت	to the limit, to the extreme (lit. with intent to kill)
هی	keeps... (intensifies the continuous nature of the verb)
ما ازوناش نیستیم	We are not those kind of people; we are not like those people
کنایه آمیز	sarcastic, sardonic
نازنین	Nazanin (a proper name)
زیاده روی کردن	to overdo something, to go too far
حواسم جای دیگس	my mind is elsewhere; I'm distracted
کس شعر	damn, fuck, bullshit
جیبی	pocket-sized
دادن	having sex, putting out
شله زرد	saffron rice pudding (a votive offering)
دارم کظم غیض میکنم	I'm controlling my wrath/restraining my anger
حشر پسر دارم	I'm horny for boys; I'm into boys
جنده	bitch, hooker, whore
پول چارتا سیگاره	money for four (packs of) cigarettes
زید	squeeze (girlfriend)
فلانطور نشه صلوات	say a prayer (salawat) so nothing bad happens
در عالم هپروت	in a daydream, in a daze
کول پنداری	a way he thought he'd look cool (cool-like)
داف	attractive, beautiful
از پس فلان برنمیاید	you can't handle so-and-so; you can't deal with so-and-so
جاکش کافر	infidel pimp
یه مو بینش فاصله اس	only a hair separates them
دختر لات و ولویی	a fast and loose girl
دسته عزاداری هیات سقا	sagha mourning procession (during Muharram)
آواز شقایق	song of the poppy
درش آوردن	To remove it, to take it out
عه عه	Uh-oh
متولیان امر	the authorities
برای یه مشت گلابی	for a bunch of idiots (lit. pears)
برای خودش کسی شده	he's become a somebody
تار عنکبوت	spider's web
کارت پخش کردن	to hand out (advertising) cards or flyers
آمپول زدن	to give an injection, to give a shot
فازش چیه؟	What planet is he on? What is he babbling about?
طرف تیر بخوره	someone is gunned down/picked off
با نصف محل	with half the neighborhood
هنگه هنگه	it's hanging/crashing
بام پرواز	flight roof, landing roof
هوا متعادل شد	the weather cleared up
دلم رفت کربلا	my heart winced, I felt sad / miserable (lit. my heart went to Karbala, I missed being at Imam Hossein's shrine in Karbala)
بحث کردنای الکی	useless haggling, frivolous arguments
اصن ی وضعی	What an embarrassing situation! (اصلا یک وضعیتی است)
دلم قرص می شود	I feel relieved, comforted, warm and fuzzy
خر ذوق شدن	to become extremely thrilled by something, to love something
دان میشه	it goes down
قیمه من گوشت نداشت	my stew didn't have meat
چسناله	pissing and moaning, whining
جنستون	your stuff
گوشی	cell phone, smart phone, mobile phone
گشادم	I'm a lazy ass
باز تا صب سگ لرز میزدم	I still shivered like a dog until morning
همه برن	everyone can/shall go
داد کسی درآمدن	to complain about something
در جوی حقیری	in a little / small stream or brook
مفت بخشيدن	to give something for free
بخاطر بسپار	remember, bear in mind, keep in mind
محتاطانه گام برداشتن	to tread carefully
صرف با شماست اگر	it's more economical for you if, it's in your benefit if
گله به گله	everywhere, in various spots
هیچگاه هم آغوشی هایت را با عشق مقایسه نکن	Never confuse sex with (true) love
عهد بوقی	antiquated, outdated, obsolete
تا دیر زمانی	for a long time, for ages / years
چگور پگور	cool, hip, trendy, lovely
دختر سر راهی	an abandoned girl, a doorstep baby, a foundling
این جوری از آب درآمده	it turned out this way, it ended up like this
یک راست	directly
حرف‌های کلثوم ننه‌ای	Victorian talk
قند تو دل کسی آب شدن	to anticipate joyfully and impatiently, to have butterflies
به آب و آتش زدن	to go through fire and water, to pull out all the stops
سوپر مارکت سر گذرشان	their supermarket around the corner / down the street
نان و آبش هم مرتب باشد	he has regular food on the table (i.e., a steady income)
Hayf	Too bad, what a pity, shame
تسلیت و تعزیت	(to offer) condolences and (to wish) patience
او پقی می زد به خنده	he suddenly burst out laughing, he suddenly burst into laughter
پشت دستش را گاز می گرفت	Bit the back of his hand (a gesture)
آدم خیال می کرد	one would think that, one would assume that, one would imagine that
سرجای همیشگی خودشان می نشستند	they would sit in their usual spot
داشت پر می شد	was filling up, was about to be filled
رخت خواب	bedding
شب روضه هفتگی	night of (our) weekly prayer meeting
صم بکم	deaf and mute
زبان بریده به کنجی نشسته	sitting in a corner with one's tongue cut off (speechless)
به از کسی که نباشد زبانش اندرحکم	is better than a man who has no control over his tongue
ملت ما یک مطلبش این بود	our nation has believed that, one of our nation's arguments was that
به نقش آفرینی پرداختن	to play an effective role
حراست مراسم	event security, ceremony security
به‌ما‌هو	per se
زیور طبع یافتن	to publish
Tan be... dadan	To accede to, to yield to
حاشیه سازی	casting doubts and spreading rumors; marginalization
فرضا	for example
کلید خوردن	To launch, to start
Dar shorof-e... budan	To be about to do something
مگه داریم٬ مگه میشه	We don't have any, do we?
سیاه بازی	cover-up, show, farce, vaudeville
شب ریختن تو خونش	raid their houses at night, rush to their homes
تو یه کاسست	in bed together (lit. in the same bowl)
(بلانسبت (بلا نسبت شما	present company excluded
نون به نرخ روز خوردن	To blow with the wind, to bend with the wind
بشکنه اين دست كه نمک نداره	no good deed goes unpunished
بیب رسانه ای	Bleep (sound)
یه زمون	There was a time when...
از مسلمانان رو بر میگرداند	turns his back on Muslims
شروط ضمن عقد	articles of marriage
Kheyr-e saram	Silly me, poor me, stupid me
Chakhan pakhan	Bullshit, cock and bull story
Pedaram daramade	I'm worn out; I've had a hard time of it
mahz-e nemune	as an example, for example
Deh behtar	All the better; better, duh!
Man rad sham	Let me pass, let me through
gol pesar	good boy
سکونتگاه های روستایی	Rural settlements
Engar na engar	It's as if nothing; like talking to the wall
Kandan	To peel off, to remove
برون شهری	intercity/nonurban
تشبیه	simile
عالِم ربانی	divine sage
گواهی نامه هنری	art certificate
فیش	pay slip
بلبل زبونی	amusing chatter, glib talk
حسابی طالب	really enthusiastic about, truly eager for
peef peef kardan	to grumble while eating
velo-and	scattered all over
vanet	pick-up truck
Gor gereftan	To flare up; to feel like one is on fire
khat o neshun keshidan	to draw a line in the sand
Kheyli am agha id	You're a real guy/gentleman
دایر است	is up and running
Madar nazaydeh	the man hasn't been born yet who can...
Damet garm	Good job, well done, nice move, way to go
Kharesh bishtar mire	He has more influence; he carries more weight (he can pull strings / has connections)
Qabel-e nadare	You're welcome, don't mention it, it's on me
Adashe	He is acting/pretending
az dahn mioftad	it's getting cold/unpalatable
Ba man kal kal nakon	Don't mess with me
Dam bar avardan	To exhale
khodeshe	it's him / her
tof bar...	damn... (lit., spit on)
ما هواتو داریم	We've got your back
ابو قراضه	wreck, piece of junk, clunker
Khod kefah	Self-sufficient, independent
Vaghtetun bekheyr	Good morning/good afternoon/good evening
ادب مرد به ز دولت اوست	A man's manners are more important than how he runs his government
be man kheyli eradat dasht	he was so respectful / kind to me
چون گردکان بر گنبدست	like putting a walnut on a dome (useless because it rolls and falls off)
چندان که	as, until, as long as
واقعه دیده	experienced
برین نسق	in this way or manner
به حکم آنکه	Because, since
محالست	(It) Is impossible
در آن قرب	In the vicinity of, in the proximity of
گمان مبر	Do not consider...; do not assume...
به جا آوردن	To understand, to interpret, to recognize
آهنگ رفتن کردن	to decide to go, to be about to go, to want to go
چو	when
روی هم رفته	Overall, altogether, all in all
سر	head
خداییش	by God
Zol zadan	To stare, to gaze, to glare
تا حساب کار دستت بیاد	so you will know which end is up / who's in charge / what's what (lit. so you will receive the bill for the work)
چرا هلم میدی؟	Why are you pushing me?
برگ چغندر	A nobody, worthless (chopped liver)
سرای باقی	the afterlife, other world
چه بسا	Probably, likely, perhaps, maybe
بر خود حرام کردن	to stop or forbid oneself from doing something; to deny oneself
چشمه سار زلال	A clear spring
عوامل اجرایی	agents of enforcement, enforcement agents, administrative officials
پیکر نیمه جان	Half-dead body
خروارها خاک	Piles and piles of dirt / soil
تا ابد سیراب	forever quenched
درد آشنایان	those intimately familiar with a problem
داغ و حسرت	great pain and regret
در منای	in view of
تکاور گارد	Commando guard(sman)
جون عمه ات	for goodness' sake, swear on your life (used when you are telling someone how important it is to do or not to do something)
چه صیغه ایه	What the hell is...?
ناقصل عقل	Dummy, dimwit
ماست مالی	Whitewash, cover-up
کاسه ای زیر نیم کاسه است	I smell a rat; there's something fishy going on
درد و دل کردن	To have a heart-to-heart, to unburden yourself to someone
خالی بند	bullshitter, liar
جوگیر نشین	Don't get carried away
روی حرف کسی حرف زدن	to oppose someone's word or command; to countermand someone
عوضی‌ ها عوض نمی‌ شوند	jerks don't change; once a jerk, always a jerk
گلستون میشه	become a utopia
به یه نون و نوایی رسیدن	to make a lot of money; to make a mint
امیدواریم به پای هم پیرشین	We hope you grow old together (congratulations on a wedding)
واسه	For
زیاد کردن پیاز داغ قضیه	To exaggerate the truth; to dramatize
کره خر	Young donkey (foal)
یهو بغلی	Suddenly the person next to me...
آب دستته بذار زمین و بیا اینجا	Hurry up and come here as soon as possible
یک بستی زدن	to have a toke (of opium)
مایه تیله	money (bread / lettuce)
بكش كنار بذار باد بياد	get out of my way, move over and gimme room
وسایل ارتباط جمعی	mass media, mass communication
دهانش قرص نیست	He can't keep his mouth shut
بتمرگ سر جات	Sit your ass down
زشته فش (فحش) نده	swearing is not appropriate, don't swear, watch your tongue
دلقک نشو	Don't be a clown
خرتم به علی	I'm your humble servant
پیر و پاتال	old and decrepit
اقتصاد مال خره	Economics is for/belongs to the stupid person (lit. the donkey)
پدرسوخته بازی	Mischief, shenanigans
پاشو بیا	get up and c'mon over
استوانه نظام بودن	To be a pillar of the Islamic regime (lit. to be the regime's cylinder)
دوره های تکمیلی تخصصی	fellowship programs
Be in mofti?	Just like that? / So easily?
گذاشتی تو خال حساس من	Now you're getting on my nerves
اندر احوالات	On/about the conditions/qualities of...
سکه گرمی	One gram (gold) coin
نیم سکه	Half (gold) coin
ربع سکه	Quarter (gold) coin
مرگ آفرین	Deadly, lethal/mortal
Man fatehasham miferestam	I will recite Fatiha for him
Khoda rahmatesh kone	May God have mercy on him
مار زخمی	One seeking revenge (lit. a wounded snake)
تأثرات ما زیاد است	We have so many sufferings/afflictions
به درد خوردن	To come in handy; to be useful / of benefit
مایی که	We (are the people) who...
امداد غیبی	Invisible blessings/help from God (lit. unseen help)
Semat-e rasmi	Official position
روحش شاد باشه	May he rest in peace (lit. may his soul be happy)
Jamun tang-e	Our space is tight/cramped
پشتکار داشتن	To persevere
سکه یه پول کردن	to humiliate someone
وسط کشیدن	To weigh
Zan-e aaghel	Wise woman
خونه دار	homeowner/landlord
چند و چون	details/circumstances of
بازی قایم موشک	hide-and-seek
خاصیتی داشتن	To be effective, to be of use
برخورده باشید	you will come across / see that
Kofreh eblis	Notorious (lit. the curse of the devil)
موارد زیادی را شرط کردن	to set many conditions/criteria
جمله اعجازآمیزی	a wondrous/miraculous saying
با این حال	However, nevertheless, despite this
عمق بخشیدن	To deepen
آشغال	shit, rubbish, bitch
ترکش خوردن	To be hit by pieces of shrapnel
!اجرتو از بین نبر	Don't blow your (heavenly) reward!
ازینجا خلاص شم	so I can get out of here
آزادمرد آزادمردان	freeman among freemen, freeman of freemen
سر تسلیم فرود آوردن	to bow (one's head) in submission / surrender, to bow and scrape
و با این همه	and yet, however, nevertheless
پاس داشتن	cherish (the memory of); commemorate/celebrate
سر ستایش فرود آوردن	bow to ... in praise / gratitude
الکی پلکی	bogus schmogus / nonsense schmonsense, gibberish
حال را گرفتن	to turn someone off, to rub someone the wrong way, to bother / annoy someone
امقی	عمقی (depth)
شرومیشه	شروع میشه (begins)
انگشت به لانه زنبور کردن	to kick / stir up the hornet's nest
حرف دو تا نشدن	To stick to one's guns / to refrain from changing one's mind
در به در کردن	To stray/wander (lit. to go from door to door)
شه	شود (becomes)
همه دار و ندارم	all I have / own, all my assets
وطن پرست	Patriotic
...با این نگاه نحست (نحس ات) خواهی دید که	with your sinister looks you will see that...
...فکرشو بکن بیست دقیقه دیگه	Imagine, twenty minutes from now...
به افتخار مرام و مسلک	in honor of ...'s ideology and principles
Show me your face	سرتو بیار بالا ببینیم
بد اخلاق	Ungracious, bad-tempered
خیلی مخلصم	great to see you, pleasure to see you (lit. I am devoted to you)
بر کسی پاپوش دوختن	to frame someone, to bring false charges against someone
سر دامبی کردن	to bang, thump, thrash one's head
بازشکافی	re-opening (of a case/file/investigation)
از کنار هر کس	I will kill whoever lets it get past/by him
کار بعدی	The next thing they did was to take their clothes off ...
فرار به جلو	to escape or break forward
بس شگفت	Very strange, extremely odd
Olgooyeh shekast	failure pattern
dastetoon dard nakoneh	More power to your elbow!/More power to you!
EnherAfeh meyAr	standard deviation
Geranrookeshsani	elastoviscous
Elevator pitch	نطق آسانسوری
KhatAyeh bagimandeh	Residual error
Naghzeh borazesh	lack of fit
قافله سالاری	leadership, pioneering (lit. leader of a caravan)
...تا چه رسد به	let alone...
ثروت و سامان	wealth and prosperity
دیگی که برای کارگران نمی‌جوشد	(something) that has no benefit for the workers
از همان جا داد بزنند تا من بشنوم	Woman: Well, tell them shout it out from there so that I can hear.
cheghermegi	Toughness
قابلیت کارکرد موتور	engine/motor output capacity
سه راهی شیردار	three-way connector with valve(s)
سوخت تقطیری	distillate fuel
موتورهاا اهميت ويژه اي پيدا كنند	become of special concern/ gain a special importance/significance
GarmAyeh vijeh	specific heat/thermal capacity
بازنگري	review
kasr e hajmieh mAddeh	Volume fraction of the constituent
گواهي اشتغال به كار	Employment Certificate
garmavazn sanji	Thermogravimetric analysis
Khakeh rosseh eslah shodeh	Modified clay
rizsakhtAreh nanocomposite	Nonocomposite microstructure
estehkameh kesheshieh amood bar alyaf	Tensile strength perpendicular to grain
Keshesheh movAzi bar alyaf	Tension parallel to grain
ezdiadeh tooleh amood ba alyaf	Elongation parpendicular to grain
ezdiadeh tooleh movAzi ba alyaf	Elongation parallel to grain
darsadeh (%) vazni	Percentage by weight
ezdiadeh tool ta paregi	Elongation at break
Tanesh	stress
Kornesh	strain
Parash sanj	diffractometer
soraat e khatiieh fada shodan	linear ablation rate
Ayegheh havi	insulator containing
لنت ترمز	Brake pad
Fadashavandegi	ablative
به پاهای قرصم روی زمین نگاه کنم	look at my unshaking/firm feet on the ground
Slim in	نگرانی من در باره کشور آمریکاست که حاضر هستید در آن زندگی کنیم
خر چه داند قیمت نقل و نبات	cast (one's) pearls before swine
حالم به هم می خورد	It makes me feel sick
تو کف بودن	to be filled with longing
قرار گرفت	amounted to
تزلزل سیاسی	political instability
مفاصا حساب دارایی	Tax clearance certificate
نرمالیته سود	NaOH Normality
تحت تاثیر	affected by
بدفرم	malformed
راهنمایی	supervision
بزه دیده شناس	Victimologist
جایگزین حبس	Alternative to incarceration
رگ گیری	(finding) IV/intravenous line
to cap/crown/top it all (off)	بدتر از همه اینکه....
درناژ چارت شد	the drainage was charted
هاله حرارتی	thermal halo
پایین بودن سن	early age
حول و قوه	might and power
سیر حوادث	chain of events, course of events
به سوی خدا بیزاری جستن	to seek God's absolution by hating (someone or something)
آبدارچي	tea boy, Tea lady
واي به حال تو	let alone, say nothing of you
وحی تشریعی	prescriptive/legislative revelation
پس بگو	Now I see!
تجلیات اسمائی	manifestations of Names
کثرت وجود	superabundance of being
همينم مونده كه.....	all I needed was...
خطابه‌ گویی	making, giving, delivering oration
به محض اینکه	As soon as
خواه ناخواه	Like it or not, inevitably, unavoidably
از آن طرف پشت بام افتادن	To overdo something; to take too wide an approach
تا حتی الامکان	as far as possible, to the extent possible
دنبال میز و جیب شان هستند	They are holding onto their desks and lining their pockets
اصل و نفس	root and branch; basis and essence
حیاط هیات دولت	yard of the presidential office building
بازی‌ در دونقش	Dual role-playing
هرچي خدا بخواهد	Whatever God wills/ whatever God wants
هم هوایی	Soul Mate Symptoms -- Homesick Mate
تأثیرپذیری	affectibility
گند کثافت کاری هاش در نیاد	so the shit wouldn't hit the fan
آیین نامه انضباط کار	corporate code of conduct
قدرت گرفتن يزيد	come to power/take power/take control
استفاده ابزارى	instrumental use
no objections	اعتراضی ندارم
سهم چیزی در توضیح	the part something plays in explaining...
اتفاق مبارک	fortunate event
انقلاب از بالا	Revolution from above
قساوت	hard-heartedness
تشبیه گرایان	supporters of Tashbih
ماده استدلال	in ratiocination, in the real sense of the word/ in the real sense of ratiocination
گزاره ها	propositions
ظهر و بطن	the words and the interpretations
وضع	Forging/ Fabrication
جاریه	female offspring
طراحی دست آزاد	free hand drawing/drafting/design
برون دینی	non-confessional
ظهور در حرمت	realization in religious illegality/prohibition
اصلاح و درمان	rehabilitation
ایستگاه های تقویت فشار گاز	Compressor station
رفع ايراد ميشود	fix the problem
شهرهای برنج خیز	rice-bearing/rice-producing cities
نهاده‌های کشاورزی مخصوص برنج	rice-specific agricultural inputs
بخش ماشین آلات مخصوص برنج	rice machinery sector
سوابق و تجربیات درخشان	Brilliant backgrounds and experiences
دارد از دست می رود	there is no hope for him.
رادیو مادیو	radio-shmadio
parameterized	پارامتری شده/پارامتر بندی شده
machine learning task	کار یادگیری ماشینی/ماشین وار
being that	این است که
کار از دست می رفت	All would come to an end -- All would go under
مته به خشخاش گذاشتن	to go into the hair-splitting details/ to go into the petty details
بخش حقوق بین الملل	international law
کانون گرم خانواده	warm family hearth
کانون خانواده	family hearth
projections	نمود
systems models	مدل های سیستمی/سیستمیک/حاکم بر نظام ها
contingency available at the discretion	لحاظ شود CFCOG همراه با 100000 دلار که می تواند به تشخیص
swinging into the country	با سرعت/تند به .... مي خزيدند
He thought that funny	به نظرش بانمک/بامزه آمد-- به نظرش آمد بانمک/بامزه است
He started putting up	داشت دستشو بالا میبرد
Swiss cow-bell	زنگوله
گره کور	Gordian knot, deadlock, stalemate, insoluble problem
اعتدال گرایی	moderation/moderationism
بیمارگونه	disease-like
موسوعه	Encyclopedia
تبارشناسی	Genealogy
متضایف	Correlative/interrelated
مودیان مالیاتی	taxpayers
تکفیر از تأسیس تثبیت	excommunication since the very beginning of establishment/stabilization
جاه	Dignity/(high) status/glory
اجمال و اتفاق	implicitly vs. unanimously
برون رفت	exit
پایگاه اطلاع رسانی آثار	Website for the works/publications of...
تفسیق می شدند	were accused of debauchery
سلب بهانه	to remove (any) excuses from
ثنایی	dualism
به نسخ قائل می‌شدند	adjudged them void
نرخ	rate
به اندازه 0.0143 کاسته خواهد شد	will decrease by 0.0143
به ازاي هر 1000 تومان افزايش هزينه	per/for each 1000-toman increase in costs
اگر هزينه سفر به اين منطقه صفر باشد	If the costs of travelling to this area are none,..
برنامه ریزی	planning
سر و وضع	appearance, clothes, looks
راه و چاه	The ropes / do's and don't's / the solution
عملکرد	Fiscal year for سال عملکرد and Type of activity or Type of entity for نوع عملکرد
مودی	taxpayer
ساقی و باقی	serving (ones)- deserving (ones)
فعالیت همه جانبه	effort from all sides
تلقی به قبول کردن	to believe/take something to imply acceptance
باز و جمع شدن (صندلی)	kick back and restore
هنرورزی	workmanship/craftsmanship/artisanship
به دست ايادى	by ... agents
مراجعه به مراجع	recourse to authorities, calling on the authorities
پوست کلفت	thick-skinned
به گمان جلب نظر	in order to curry favor with/ingratiate
تعمیرات دیزل	diesel repairs
طراحی مدار برش سنگ	stone cutting water circuit design
برق کشی سوله های مرغداری	wiring the poultry house
از هیچ خدعه‌ای فروگذاری نکرده	Having not stopped short of any ruse/deception.
علوم تجربی	Experimental Sciences
سفارش کردن	to ask one\'s special consideration for
پیوند زناشوئی	matrimonial bond
همسرداری	Conjugal life
انحراف معیار	Standard deviation (SD)
نمونه گیری	sampling
انتظاماتی	security officers/personnel
حق بدن	to think I am right/to agree with me
رفع زحمت کردن	we better be going/leaving
پردازش	process
کار شناس ارشد	MA, MS or MSc/senior expert
کافرانه	(death as an) unbeliever
انجمن صنفی کارگری	Workers' association, workers' trade association
سود و اسید	caustic soda (sodium hydroxide) and acid
دادستان کل	Attorney General
تصرف نقل عین	the property transfer possession
شرط نافع بودن تصرف	exploitable condition of the possession
رهن مکرر	repeated mortgage
مرتهنين	mortgagees, pledgees, holders of a mortgage
معاملات فضولی	unauthorized transactions
معاملات وثيقه اي	secured transactions
تصرفات مال مرهونه	pledged asset possessions
تصرفات منافي،	Adverse Possession
قاعده تسليط	Absolute legal power of the owner to exercise control over property
پوشش تکمیلی نوسانات دیه	supplementary coverage for fluctuations/variations/changes in the blood money amount
کارشناس ارشد صادرات و فروش آزاد	senior specialist, exports and free sales
معاونت فنی مهندسی	technical and engineering deputy
پایبند به عروض گذشته	adhering to the past/classic prosody
تعهد مستمر	Continuous commitment
رضایت از ماهیت کار	job satisfaction / satisfaction from the nature of the job
اساتید حق التدریس و رسمی	adjunct and full-time/permanent professors
کاردانی ناپیوسته پودمانی	modular non-continuous associate degree
اجرای ساختمان	Building construction
تهاتر	set-off
تاثیرپذیری بالا از تشعشعات	being highly influenced by radiation
حوزه ها	hawzah
واریز تک بانکی	single bank deposit
بستانکار	creditor
شیر خام خورده	ungrateful/disloyal/thankless
سابقه خدمت	length of service
حجم نمونه آماری	statistical sample size
اسناد بالادستی	high level documents
دوربین ستاره	Night vision astronomy binoculars
مورد وکالت	powers of the attorney
وکالتنامه جهت عزل وکیل	Statement revoking the appointment of an attorney or attorneys
دوره تکمیلی	supplementary course, complementary course
حق توکیل به غیر	the right of substitution
دار فانی وداع گفتن	to bid farewell to this mortal realm, to depart this life
دوپس‌دوپسي‌	(dance) music maniac
طرف شبهه	Party of doubt/skepticism
در خور توجهی	worthy of attention, worth considering, noteworthy
Smoke and mirrors	دغل بازی
خیال آسوده	ease of mind, peace of mind
سبّ سلف	beshrew/curse the predecessor(s)
the court saftey and barring orders	احکام دادگاه مبنی بر حفظ امنیت و منع مزاحمت
affidavit of means	گواهی دارایی
گذر و بازارچه فتوت	Fotovat Bazaar and Pass
تاتوله خورده بودند .	(as if) they had eaten jimson weed/locoweed
از علم و فرهنگ ثقل سرد بکنند	(to) turn them off science and culture big time
حق فنی نظامت مدرسه	assistant principal's allowance
مرا به صرافت انداخت	it occurred to me...
داشتم دماغم با بوی خاک نم کشید ه اش اخت می کردم	My nose was getting accustomed/becoming inured to the smell of its wet soil
خوب چرا تا حالا پاکش نکردی ؟	So why haven't you erased it yet?
نوایی صمیمی	a friendly tune/melody
اقصای عالم	(from) the ends of the earth
از دور علم افراشته ی هیکل معلم	in the distance the raised ensign in the shape of the teacher
جاری شدن صیغه طلاق	Execution of the pronouncement of the divorce
قامت	body-height
بهتر از این نمی شد	It couldn't get any better
استغناء با غین و استقراء با قاف	phone is spelled with ph and rough is spelled with gh
قدیمی ترین شعر دری	the oldest Dari poem
به شدت رنج بردن	to severely suffer
اجرای آسفالت محوطه	Asphalting of an area
سرودستی برای این کار بشکند	prepared to exert the neccessary effort to secure the principle's position...
واحد شمارش دینار	counting unit for the dinar
ناو هواپیمابر	Aircraft carrier
دو تای یک آدم حسابی	twice as big as an ordinary man
بفهمی نفهمی	more or less
عیب شرعی و عرفی	legal and customary flaws
دست است که پیش از بلند شدن بوی اسکناس	It`s true, until the smell of money arose
جزو پرقیچی ها ی	among the paper dolls hanging around the chief
جایی بخوابند که آب زیرشان نرود	to feather thier own nest
کله اش بوی قرمه سبزی می داده	to harbor dangerous or radical thought
صنعت ارسال مثل و رد العجز	Literary devices like anadiplosis and proverbial figures of speech
گروه آزمایشی	examination group
خالی نبودن عریضه رونویس	Not to be left empty-handed
نوع سهمیه	type of quota/quota type
در حال تصفيه	Liquidating, dissolving, settling
لحاظ علمی	in terms of/for his knowldge of science
خانه تیمی	cabal house
وقت هواخوری	yard time
پرده درى	effrontery
ماهنامه نمايه دفاع	Defense Index Monthly Magazine
قمچیل	saber/sword
آئین زندگی )اخلاق کاربردی(	Way of Life (Applied Ethics)
بالی حاکم کارگزینی کل	who could say anything about...?
حرف توی چشم کسی زدن	talk frankly/straight
استاد تمام رشته	Full professor
رونویس حکم	transcript/copy of the order/instruction
خاتم الاولیا	the seal of the saints/guardians
'عبودیت محض'	downright servantitude
احقاق	realization (of financial rights)
اخذ می گردد	is charged/received/collected
به عرض می رساند	this is to inform you that...
واعظ غيرمتعظ	non-practicing preacher
رساندن	show, suggest, be indicative of
تعلق گذفتن تسهیلات	to be entitled to the (company) facilities
‏پیش ببرم	to develop/make progress
شرایط ممتازی	conditions for being top students
اطمینان دادن به کسی	to (re)assure someone
نرم افزارهای قفل شکسته	cracked software
مناقصه گر	bidder
معادلسازی مدرک دانشگاهی	equating academic credentials
شرکت-سال	company-year
زلف یار	Lover's hair, lover's locks
طراز اول	Top-ranking, top-level, top
به خود باکی راه ندادن	to not be afraid of, to have no dread or misgiving
اکثریت قریب به اتفاق	the overwhelming majority, almost all
پشۀ جلز و ولزی	sizzling/spluttering mosquito
در طبق اخلاص گذاشتن	to make a sincere offering
به حال خود رها شدن	to be left unattended, to be left to their own devices
کنار گود نشسته، میگه لنگش کن !	a backseat driver
نا رفیق	backstabber
بی مرام	unprincipled
دم هرچی رفیقه گرم	cheers to all true friends
چیزه	um
دودی کردن	to darken/to tint
دختر شاه پریون	king of fairies' girl
از قرار اطلاع	According to reports, evidently
انتقادپذیر	open to criticism
دامت افاضاته	May his grace last long, may his grace abound
اقرارنامه زوجه	the wife's affidavit
عقد خارج لازم	separate binding contract
شرط ضمن عقد	proviso
موصی له	legatee
مفهوم مخالف	argument a contrario
کانون وکلای دادگستری مرکز	Central Bar Association
زیر دیپلم	less
ترس از خاتمه رابطه زناشویی	fear of marriage/marital breakdown
جان بر کف نهادن	to put one's life on the line (for something), to be ready to die for country, nation, a belief, etc.
قبضه سلاح	Weapon
چشمشو دور دیده	to take advantage of somebody 's absence
مگر	How much
دیگر این حرفها از من گذشته	I am too old for that stuff
یه سیب رو بندازی هوا چندتا چرخ میخوره تا بیاد زمین	There is many a slip between the cup and the lip
idioms	اصطلاحات
عفت الملوک	Effat-ol-Moluk
هوای چیزی در سر داشتن	to have a soft spot for sb/sth
دشمن فرضی	imaginary enemy
همانند سازی فرافکنانه	Projective identification
تا به حال صد تا پیغمبر آمده بود	up to now a hundred prophets would have appeared
اگر در قرآن مجید حتم نشده بود به خاتمیت ایشان	If his seal of prophecy had not been ensured in the Holy Koran...
برم	berm
متن مردم	the fabric of society, the thick of society, grassroots
ميسر و مقدور	possible, achievable, feasible, viable
از بدو	from the start of, since
به چندین کتاب می ارزد	worth quite a few books
مقدس‌مآبان	sanctimonious, self-righteous, hypocritical
بار و بنه سفر بندیدن	to pack one's traveling bags
نرسیده به	before / after
سلم و مدارا	Tolerance and moderation
با ایشان هم جلسه ای بودن	To be in the same group with them
بروز و ظهور پیدا کردن	To emerge, to appear, to manifest itself
بر زبان راندن	To bring something up, to talk about something, to voice something
صد البته	definitely/surely
بسا که	it is likely
ابلاغ	formal/official notice/notifying/notification
خود قرينه داشته است	which has an indication of
از وضعيت پلمپ خارح وفك شده	it was unsealed
خطوط كشتيرانى	international transportation and shipping co)
تحصيل مال	property acquisition/obtaining money/gaining money
بازداشتگاه اوين	Evin House Of Detention
پلاک	No. (house/building)
داير بر	in re/apropos
اتهام ها	accusations
قانون تشديد مجازات عاملين متخلف	The Act of Enhanced Punishment/Punishment Enhancement for the Offenders
به تحمل	sentenced to
بلا وجه	injustifiable/unjustified
محیط زیست	environment
بشر	human beings
به تفکیک استان	by province/city/town/etc.
یکی از ما دو نفر	one of us two
تارو پودی بودن	be in a warp and weft form
غیر مشبک	non-perforated / solid
کف بستر	bed
کی سینگ	casing
گروه شاهد	control group
مقطع تحویل و تحول	Delivery and Transition Phase
بهره گیری	utalization
تبادل حرارتی	heat transfer/exchange
نزولات جوی	Atmospheric precipitation
بهره وری انرژی	energy efficiency
دعوت به همکاری	call for applications / job vacancy / invitation to participate
نظارت بر حسن اجرا	supervision to ensure quality performance
جدول زمانی	timetable
کسی که ملک به نام او به ثبت رسیده یا منتقل شده است	the party to whom the property has been transferred or was registered
به نام	in the (owner\'s) name
تنظیم و ترتیب	preparing and ordering/ setting and ordering
يكى به ميخ يكى به نعل زدن	To run with the hare and hunt with the hounds
رونوشت	cc (carbon copy)/Copy to
ذیحساب محترم	comptroller
روایی و پایایی پرسشنامه‌ها	questionaries' reliability and validity
احساس هویت و وابستگی	sense of indentification and affiliation
نمی گذارم آب در دلت تکان بخورد	you won't have to worry your head about any little thing
دخترم	(my) dear
حجم نمونه برخاسته از جامعه مذکور	sample size based on the mentioned/target population
ﻟﺒﻨﻴﺎﺗﻲ	a dairy shop
ﻫﻴﺲ	SHUSH/HUSH!
نهادینه	Institutionalized
بستر ارتباطي	communication infrastructure
انتسابی	assigned
به صورت تفصیل	seperately
مالیات مکسوره	deducted tax
حساب واسط	escrow account
در جریان وصول	pending credits
ریالی	based on Local Currency
ذخیره ی بازخرید سنوات	severance package/severance pay
کمک های بلاعوض	grant-in-aid
منفک شده	terminated
حق الزحمه ای	hourly rated employee/contract labor/free lance worker
دارایی زیستی مولد	productive biological asset
جرایم تعلق گرفته	attached fines
حسابها و اسناد دريافتني تجاري ذخيره مطالبات مشكوك الوصول اشخاص	Business accounts and receivable documents for the questionable claims reserve
به باد دادن	to squander, to misspend, to waste
از باب اینکه	because, since, due to, thanks to; in terms of or in the sense of
حق نحله	Nehle Right/ arbitrary donation
اصل استصحاب	principle of presumption
درآمد مشاع	joint/mutual income
مستکتومی	‎mastectomy
لمپکتومی/لامپکتومی	Lumpectomy
درمان جانشینی هورمونی	Hormone Replacement Therapy
نظام جدید	new educational system
spare capacity central problems	مشکلات اصلی ظرفیت آزاد
گوارا باد	may they enjoy...
لاهوتی-ناسوتی	theanthropic(al)
فلج عضلانی اسكلتی	Skeletal-muscular paralysis
داروهای مسدود کننده عصبی – عضلانی	Neuromuscular Blocking Drugs
علی الرا س	Ex- officio
اتساع شکم	Abdominal distention
کاکل ذرت	corn silk
قطع شدن اب	water outage/shut off/turn off
تخت گاز رفتن	to go flat out
در صورت صلاحدید اعلام فرمایید	Please let me know the status of....(my documents/application/etc)
با سلام و عرض ادب احتراما خواهشمند است	Dear .... please...
balance of payements	تراز پرداخت ها
bank statement	صورت حساب بانکی
نفوذ پذیری بسته بندی	packing permeability
ذوق کردن	to be excited/to jump for joy/to be jumping out of one\'s skin
ارتقا عملکرد	Improvement of performance/efficacy
بگم بگم	tattle/tattling/tattletale
آموزش	cross training
ضريب نفوذ بيمه	insurance penetration rate
حق بيمه سرانه	premium per capita
ضريب خسارت	damage/loss coefficient
از رو بردن	to outface/outstare someone; to stare someone down
ورق	sheet metal
اینکویری	inquiry
سر خشت رفته بود	... on the bricks giving birth...
دست خر تو لجن زدن و خاک تو سری کردن	do the dirty/do the nasty/do the thing
مچاله کردن	to wad something up/to crumple
پای ثابت چیزی بودن	to be a fixture of something
دركشيده بجاى زنارى	instead of the saddle has put on ...
به اجاره در آورده بودند	had rented
مرده ريگ	relic/leftover
كه عكس اوست دوكون	Her countenance is the reflection of both universes
چه پیداد مي کند	what an outcry (the Poet) makes/raises
درآن بزمگه بود وبنواختش	there, he was in the feast, he soothed him
مقطع الرأس أو	the farthest place he has ever been/traveled
آنچه يافت مى نشود	[What is] not will be found / not discoverable
مكاره شان هفتگى است	their annual market lasts for one week
تاج مكللى	bejeweled (jeweled) crown(coronet)/ crown(coronet) studded with jewel
عارفانه وار	like a mystic (Sufi); as a a mystic (Sufi) does
روگيرى	coverage
به ادغام درآورده	unified
سعايت اطرافيان از ديگران	close freinds/people close to him defame/slander others
حقه	rightful/truthful
شترچران	those who raise and breed camels/Camel-breeders
ومهاجرت دسته جمعى	group migration
موارد تمهيدي	primary works/actions/steps
عوامل بيگانه	foreigners/foreign agents
تازه نفس	fresh/new/recently developed
خان خانى	governments ruled by khans
جفت باز	base pair
مسلسل نارنجک انداز	In \US military English\: automatic grenade launcher
پاره شونده	rupture / bursting disc
پرانرژی	high-energy / energetic
آفرينندگان برقع	people who make the Burqa
گاهی دچارخلجان مى شود	is sometimes afflicted with perturbation/agitation
بروى زيدى جلوه گرى	is beautiful on one person
طبع او جوانى مى كند	he behaves like young people
عشق را يا مال بايد يا صبورى يا سفر	the solution for love is either wealth or patience or trip
آنچه كه رشته اند بافته اند	reaped what they sowed (had sown)
روى كار پندار شاعر برگرفته است	away/across from the notions/fancies of the poet
پس پندار	in the deepest place of mind
تردی	Brittleness
شیر تخلیه	drain valve
استحکام کششی	tensile strength
تست گوی ضربه ای	charpy impact test
تست اسپارک ولتاژ قوی	high voltage spark testing
منو ترکوند (mano terekund)	it blew me away
چو ديد	once he saw
سر روز روشن درآمد به خواب	The bright day got to sleep
مردافگن	virile/valiant_sth which overwhelming...
گشاد از جهره مشكين برقع آن مه	drew back/removed/unfolded Burqaa from her musky countenance which is moon-like.
آبرش حسن برون تازامشب	let the mare of beauty gallop tonight
بي خزان	everlasting
ادعاى نيمه حجابى از آن ميرود	which is claimed to work/function as a half-veil...
سر نفوذگر سهمی شکل	the tip/head of the parabolic penetrator
محراب جمشيد	altar/sanctuary of Jamshid
گل اندود	mud-covered
بى وجود برقع جمال يار دل آرائى مى كند	with no Borq lover 's beauty/charm pleases me/comforts my heart
حاجت مشاطه نيست روى دل آرائى را	no need is there for a beautician to dress up one whose heart is well-natured.
كسر خدمت حضور در جبهه پدر	military service reduction owing to father's participation at the war front
حوزه اعزام كننده	Dispatching Unit
محیط سنگی	lithic environment
پخش ابر سيستم هاي هوا-سوخت	dispersion of cloud from fuel-air systems
تحلیل شکست مایع	refractive index analysis of liquids
انتظامى	law enforcement (police)
خودمشتعل شوندگی	Autoflammability / Self-ignition
ستوان سوم وظيفه	third lieutenant (conscript/ draftee)
بازار تيز كردن	To arouse/to make keen
روش معيار بهينگي	optimality criterion method
برافگندن	to doff/to draw back/to remove/to take off
منس	Menes
بهمنى والى دكن	Bahmani, governor of Deccan
روش تشخيص ترك يا نفوذ	crack or penetrant detection method
جريان گردابي يا مغناطيسي	magnetic or eddy current
man ham megam	that's what I say!
آنچنان را آنچنان تر مي كند	It intensifies that quality
روش مافوق صوت	ultrasonic testing method
فوق مركزي	hypercentral
رادیو داروهای استخوان خواه	bone-seeking radiopharmaceuticals
گفتارهاى ناكردار	statment without deed or saying without acting.
شایعه پردازی	circulate/spread rumours
ديد زدن	watch/behold sth
حضوراً منع كرده است	forbid in his presence/in the presence of himself/in person
دست رد بر/به سینه کسی زدن	reject somebody, turn sb/sth down
علت موجده و معدّه	primary and secondary reasons
تدلی	Becoming close/suspending hung (to Allah)
مد باصطلاح	so-called fashion/vogue
سخن آفرين شده است	controversial issue
از کردن چیزی ابا کردن	to refrain from doing something; to refuse to do something
کانتر	catheter
خر کسی از پل گذشتن	now that you have crossed that bridge...
افسون گرى	bewitching
جسته وگريخته	haphazardly/inconsistently
درستى كلمه برگردان شده ء ان	The accuracy of its rendered/translated word/equivalnce
اتمام حجّت	ultimatum; final word/declaration
تداعى مي كند	evoke, bring to mind
خود معرف اختلافى است كه	it represents a deference/discord
جلد كتاب	volume
طبق یک روایت هایی	according to some accounts
وقت	then-
مال بد بیخ ریش صاحبش!	bad penny always comes back/turns up
به کوری چشم کسی	let the enemy eat his heart out
سلماني ها وقتي بيكار مي شوند، سر يكديگر را می زنند	mice out, cats chase cats/each other
روز سیزده بدر ایرانی	Sizdahbedar/ Sizdah Be-dar
دمكنی	rice steamer cover
دوره احتياط ويا ذخيره	reserve
فکری_سیاسی	intellectual-political
کروکی منزل	Sketch of location
بار کردن	simmer
surveyors	پیمایشگر/پرسشگر
گازهای ورودی	input gas
زیرکالوی	Zircaloy
غلاف	sheath/cladding
مرور زمان در لایحه جدید قانون مجازات اسلامی	Statute of Limitations in the new Islamic penal code
مقصوره	Maqsurah
سردر	main entrance
اهتمام ورزیدن	to take great pains (in doing something)/to put a lot of effort (into doing something)
Do  -do-	ایضأ؛ همچنین (ditto)
انرژی منفی دادن	to give off negative energy
پا بر جا ماندن طلسم	(his) jinx stayed in place
آزادسازی قیمت خودرو	car price liberalization/deregulation
زور داره	it really sucks
بررسی خاتمیت	A study of seal of prophecy (Khatamiyyat)
اینجانب متعهد می شوم	I hereby undertake to...
در جهت پیشبرد اهداف متعالی سازمانی	for the advancement of the high/noble organization goals
طراحی حدود یک و نیم میلیون متر مربع ساختمانهای تجاری	Designed about one and a half million square meters of commercial buildings
در کارنامه خود دارد	Has on its record
صلاحیت خدمات مشاوره ای	Consulting Services Certificate / Qualification
سقوط تعهد دارنده	dismissal/breach of obligation
ارزش بازار سهم پایه	market value of underlying share/stock
ارتباطات مشاركتي	participatory communication
توسعه از نوعي ديگر	another development
نظريه اشاعه و نشر نوآوري ها	Diffusion of Innovations
پارادايم تكثر	multiplicity paradigm,
بنیاد جانبازان	Veterans Foundation
تعاونی مسکن سازمان نظام مهندسی	Housing Cooperative of Tehran Engineering Organization
ریز فشارنگار	microbarometer/microbarograph
بدنه سازی	surfacing
کارفرما: شخصی	employer: natural person
نوع دیگر کانسارها، تیب ماسه سنگی و تیپ رسوبی است.	The other types of mineral deposits are: sandstone, and sedimentary deposits.
لامپ های مولد پرتو ایکس ماموگرافی	mammography X-ray generator (tubes)
نیمه عمرهای کوتاه	short half-lives
گر همه	Whatever you do, it is your own doing even if all of it is good or bad
بالاخص	particularly
اعتراض ثالث	Third Party Objection
عامل کارگزاری	Brokerage/ Broker Agent
درز انقباض	contraction joint
چند مرتبه زیاده	much less
صحن علنی مجلس	in an open session of Parliament (Majles)
قلب راكتور	Reactor core
اندک آرزوی من	my slightest wish
کلیسای ساختمانی	Official Church vs. Home Churches or House-churches (inofficial)
به بهانه واریز پول	...justify something
شگردهای اختفاء	concealment / camouflage techniques
معوض سیاسی	political achievements/success
گلولۀ فردی‌نشناس	shot by an unidentified / unknown person
دستگاه خاک کوب	Compactor
سپاه فتح	Fath Corps
ولایت مدار	follower of the velayat-e faqih; loyal to the Supreme Leader
محرم / ئا محرم	Mahram (unmarriageable kin)/Non-Mahram
نشانه‌های مفهومی دینی	religious conceptual scenes/signs/symbols
توجه از شوهر و نگهداری چهار بچه	paying attention to the husband and taking care of four kids
به در می گویند که دیوار بشنود	to beat one to frighten another
معاون وزیر نفت در امور بین الملل	deputy oil minister for international affairs
بیع متقابل	Buy-Back
غش كردن	sing from the same hymn sheet
از کسی شاخو کشیدن	Get off someone\'s back
برو اون روی سگ منو بالا نیار	Don\'t get my back up!
بانك عامل	agent bank
نه نماز شبگیر کن نه آب توی شیر کن.	Many people preach righteousness and perform sins
دزد، آب گرون می‌خوره.	A thief seldom grows rich by stealing
مهاجرخیز	Migrant-sending
اقدام شركتی	corporate action
قیمت اعمال	exercise price
اندازه قرارداد	contract size
ارزش اعمال	exercise value
اخطاریه افزایش وجه تضمین	margin call
for the most part	تا حدی زیادی/ در بیشتر موارد
تبلیغات محیطی فوتبال	Footbal Perimeter (Board) Advertising
اعمال	exercise
اتاق پایاپای	clearing house
بازار مشتقه	derivatives market
زیرگروه هم‌ماه	Series
آخرین روز معاملاتی	last trading day
هر آینه‌ نَ	certainly / definitely
بازار مکاره	fair market
مستمع صاحب سخن را بر سر ذوق یا شوق آورد	the audience lit a fire under the speaker
کسی رو در مقابل عمل انجام شده قرار دادن	to present someone with a fait accompli
قابل اجرا دانستن	to consider something enforceable
حلقه وصل	connecting link / bridge
يه وقت	lest / be careful
مخالفت مجلس ایران با سرپرستی وزارتخانه فاقد وزیر توسط وزیر دیگر	Opposition of Iranian parliament with running/managing a headless ministry by a minister who is in c
از دماغت در مياد	you will suffer the consequences
لنگ بودن در کاری/چیزی	to be awkward/poor in sth
به همان نسبت	to the extent that....to the same extant...
معدل درس عمومی و تخصصی	GPAs for the general and the specialised courses
ضمن تبریک کریسمس	While I wish you a happy Christmas
کاشف از اعتبار عقد	realization of the validity of the contract
تصرف ناقل عين	Transfer of the (original) property
از حلقومت مي‌كشم بيرون!	I\'ll take it out of your hide
تعلیق در انشاء	contingency in the original written cotract
انشاء نشده	not stipulated in writing/in the written contract
علم مخالفت برافراشتن	raised the banner/standard of opposition
یک بلای سر کسی آوردن	to bring his life crashing down
نهادینه کردن	to establish; to adopt, cultivate (for habits)
تعلیق در منشاء	contingency in the written cotract
فرهنگ [سازمانی]	[organizational] culture
مصلحت بينى	course of action/justification
رعايت صلاح بندگان	the observance of servants\' interest/the good of servants
معلق علیه	the event (condition) in a conditional contract
تعهد ایجاب کننده معلق بر حدوث	the commitment of the offeror is conaitional upon occurance
ذمه مضمون عنه بری می شود	The debtor / the principal debtor is discharged from his obligation
ذمه مضمون له بری می شود	The creditor is discharged from his obligation
تعهد منجز	pure or simple obligation
تعهد معلق	conditional obligation/commitment
طبع عقد غائبین	nature of contract by correspondence
انرژي مصرفي	resting energy expenditure
يادآمد	Dietary Recall (DR)
پذیرش	compliance
سرعت متابوليک پايه	basal metabolic rate
صلاح کسی را دانستن	have someone's best interest(s) at heart
نمايه ي توده ي بدن	body mass index
کنترل شده با دارونما	placebo-controlled
دو سوکور	double blind
قهرمان داستان حکمین	the hero of Hakamain Chronicle
اهل کاری/چیزی بودن	to be into something / to be interested in something / to be man of something
مرکز گسترش سینمای مستند و تجربی	DEFC (Documentary and Experimental Film Center)
درسیابی	learning
تازه سر از تخم در آوردی	to be wet behind the ears
اداره مبارزه با جرایم جنایی	anti-crime office
بنای کسی بر چیزی بودن	their approach was
از این‌جهت	for/ because of/ for the reason
روي غلطك بودن	everything was going right
کسی رو دور زدن	to go behind someone\'s back/to get around someone
خودتو لوس كن	OK, be difficult!/Ok, do it your way!
چوب و چماق میخواید؟	Are you cruisin' for a bruisin'?
به روی کسی خندیدن	to let someone off easy/to go easy on someone
مو از سر کسی کم شدن	to harm a hair on somebody's head
آب كه سربالا بره، قورباغه ابوعطا مي‌خونه	When pigs fly!
آواز ابوعطا	Abu Atta mode
نگذار	don\'t let
هزار بار مردن و زنده شدن	to die a thousand deaths/times
صرف و نحو عربی	Arabic Morphology and Syntax / Grammar
خروسِ بي‌محل	blabbermouth
خروس بی محل	backseat driver; kibitzer; butinsky; blabbermouth
مسابقه ی رفت و برگشت	home and away (games/matches)
پرینتر جوهر افشان	inkjet printer
بدون پرز	lint-free
تنگه ی احد	ravine of Uhud
کارت مخصوص ضرب مهر های اضطراری	card for stamps for notable [or ‘special’] events
رودار	lid
همه چیز با هم زیاد شده	things became overwhelming
دانشگاه سراسری	nationwide university (entrance exam)
تدوین کردن	to develop; to formulate; to devise
خلاف	Wrongdoer
ابلاغنامه	Summons
شماره دسترسی اداره ابلاغ	Access Number of Summons (Processing) Department
مامور ابلاغ	process server
دعوی متقابل	counter claim
برگ دادخواست	lawsuit
حرفی از جنس زمان	I heard no word of the stuff of times
دستگاه سنگ محور	Cylindrical grinder, cylindrical grinding machine
در حدِ	as far as
واقعا چه آدمايي پيدا مي شنا!	Some mothers\' children!
ممنوع الخروج	banned/barred from foreign travel
ساخته شدن	build, develop, prepare
اصالتا	originally
نقد	review
عمق درگیری	blade cutting depth, stepdown
ضخامت درگیری	blade thickness/layer height
روزهای زوج	Saturdays, Mondays, and Wednesdays
طراحی سیستم های رکسه	Rex system design
خسن و خسین هر سه دختران مغاویه هستند	A lie / inconsistent or self-contradictory story / whopper
شابرزنی	shaping / scraping
تاریخ اعزام کارشناس	Date of specialist's deployment
دم‌دمش	right up to/right next to
what-ever-aire	هرچیاردر
قرینه های حالیه و مقالیه	similar typological and categorical instances
دبیرخانه ریاست سازمان	The Organization's Directorship Secretariat
کون لق کسی	to hell with....
استاد راهنما	Advisor
کاه از خودت نیست کاهدون از تسوت	don\'t stuff yourself just because the food is free
قرارداد کارمند پیمانی / قرارداد استخدام پیمانی	a contract employee's contract (agreement)
این درحالی است که	Yet / While / Meanwhile
هیات امناء	board of trustees
تفاوت حداقل دریافتی	difference to/from minimum wage/salary
فيچرهای اوليه	primary or basic features
جهت های بستن	orientations / directions for attaching / mounting
آي دچار دلخنكي شدم	I got full of glee (and joy)
زنان چادر شب	Women wearing jilbab
معاون آموزشی	Deputy Dean for Education/ Vice Dean for Education
ريتم	rhythm
در بدو تولد	at birth
قانون اجازه اجرای موافقت نامه	Law of (Approving and) Authorizing Execution of Agreement
قانون برنامه سوم	Third Development Plan (Law)
پیاز خلالی	Thinly sliced onion
کم آوردن	stuck for words
سهامداران کنسرسیوم برنده	Shareholders of the Winner/Winning Consortium
سهام بصورت بی نام	Bearer shares
کمیسیون موضوع ماده 2 آئین نامه اجرایی	Executive Bylaw Article 2's Commission
شتر	slice
كشیدن	impose/ to make to carry/ to burden
معاونت های رئیس جمهوری	[Iranian] Vice Presidencies
پروانه بهره بردار دوم تلفن همراه کشور	Iran's Second Mobile Phone Network Operator Permit/License
به همین راستا	as a result; thus; accordingly; in consequence; for that reason;in the same way
در پیش گرفتن	continued on his/her journey.
ماجرایی	adventure, story
دوره	era
موسسه ضامن	guarantor/warranter (institution)
دستورنامه	Rules of Order
اداره کل گمرک	General administration of customs
اوراق بهادار ترکیبی	hybrid securities
وثیقه	collateral
اجرای سند رهنی	Foreclosure
آماره * دو دنباله	star statistic of two sequences
و بس	only
شفره	knife / cutter
پیراسته	pure
حق سنوات	severance package / termination benefits
پشت جبهه	back
مکتب	movement; school
تخصّص پیدا کردن	To gain expertise in
معینی	specific/certain
شل گوش	a clumsy clot
تیربار	Machine Gun
در جا عقبگرد	About Turn/About Face
روی تخت	surface
بیسیمچی	signaller
حوصله‌سوز	patience-trying
دل آدمو مي‌زنه	cloying
هماو	هماو= هم او (همانا او؛ همان او؛ خود او)
ستیز (suffix)	anti
تعیین	determine / decide
کف	sole
در گرو	tide up, depending
فحوا	tenor, context, content
در فصول مرده	fallow season(s)
بد چم	bad sense
گنجیدن	hold/ contain/ encompass/ to be possible
بر وزن جور	rhymes with...
روایی افتراقی	discriminated validity
جهانگریزی	otherworldliness
امروز چه روزیه؟	What daye is today? What\'s the day today/what is the date today?
پای عمل به میون دادن	when it comes to action/ deeds
ادعای انتقاد	claiming to be critical of...
به چیزی برخورد خوردن	face; come across; encounter
محلّ	will it bounce?
باغ گردی	Garden walking / Garden hiking / Garden trekking
جامعه تحقیق	research population
singularity	تکینگی
[جانا سخن از زبان ما مي‌گويي ]	you took the words right out of my mouth.
بسیار سفر باید تا پخته شود خامی	travel brings wisdom
دو بامبی کوبیدن	hit with both his hands
کارورزی	internship
تو رو خدا جک نگو	Stop with the joking already!C'mon, get serious! Knock it off with the jokes! Enough with the joking!
شلوارش تو پاش بازی می کنه	his pants are flopping in the wind
پر رونق	thriving/prosperous/flourishing
جوانه زدن	sprout; bud
گذر پوست به دباغ خانه مي‌افتد! بي راه نگفته‌ان	at length the fox is brought to the furrier
جوانی است و هزار خم و چم	the ways of youth are complicated
هردم ازاین باغ بری می رسد ، تازه تر از تازه تری می رسد	Well, things just couldn\'t get better!
جای کسی درد می آد	won\'t hurt anyone
یادکردن	remember
فضول را بردند جهنم گفت هیزمش تر است	don\'t stick/poke your nose in (where it\'s not wanted)
جواب های هوی است	tit for tat/ an eye for an eye/ a tooth for a tooth
کسی که خربزه میخورد، پای لرزش هم مینشیند	As you make your bed, so you must lie on it
نشسته بر سرشاخ بن مي‌بريد	sawing off the branch you\'re sitting on
حالا کجايي که سر گنده‌اش زير لحاف است	You ain\'t seen nothing yet!; The best (part) is yet to come!; That\'s the thin end of the wedge!
ظهور منجی	the reappearance of the Savior
سینمای مسیحایی	the Messianic cinema
دویدن! از دوست به یک اشاره ، از ما به سر	just say the word and I\'ll come running
به گوش گفتند چرا فربه نشوی، گفت ز بس سخنان عجیب شنوم!	it is like talking to the fence post
آن قدر ماه است که نگو	(I/you) can\'t describe how wonderful he/she is
دو پا داشت دو پای دیگر قرص کرد	as fast as his legs could carry him
که از تعجب داشت شاخ در می آورد	he was dumbfounded/ astonished/ completely surprised/ absolutely astonished
ﻫﻴﺄت علمی رسمی قطعی	Tenured faculty member
آتيش‌بيارِ معركه	add fuel to the fire/flames / join them
سر لج افتادن	to get pigheaded/bullheaded
از خواب پریدم	I woke up with a start.
تحلیل واریانس تکرار سنجش	repeated measures analysis of variance
حوزه علمیه	Islamic seminary, theological college, or divinity school
صادق در اقرار	truthful in admission / truthful in acknowledgement
درون چاهی	Downhole, in-well
گوارای وجود: برای نوشیدنی ها	cheers
در جای مناسب	where they deem aprropriate, in an appropriate way
reflux	بازگشت اسید معده به مری / ترش کردن / سوزش سر دل
سفارش	repeat myself/remind you of
پیشرونده	expansive
حلقه چاه ارت	earthing pit, earthing well
کله کسی باد داشتن	to have one\'s head in the clouds
در آن واحد	at the same time/simultaneously
ماهي را هر وقت از آب بگيري تازه است	It\'s never too late to mend.
حرف حسابش چيه	What he\'s got to say / what he\'s up to
امنیت زدایی	Desecuritization
برق از چشمانم پريد	frighten one out of one's wits/ be scared shitless/scare the daylights out of somebody
يه آشي براش پخت كه يه وجب روغن رويش بود	to fix someone\'s wagon
خناق گرفتن	To have a lump in one's throat; to feel suffocated by fear; to remain silent
گرافیک و نقشه خوانی	graphics and diagram reading/interpreting
نقش مقابل	(play/ act) opposite
به گردن کسی حق داشتن	to be beholden to someone
مواد اوليه	raw material
اصول طراحي منو	menu design principles
آحاد مردم	all the pepole in society/ people from all walks of life
دهن کسی کف کردن	one\'s jaw drops
شیری یا روباه؟	Did you get it?/ Any sucess?/ How did you make out?
دلاک	rubber
شَفْت	drupe
چند مرده حلاج بودن	what is in your heart/ how rightous you are
حلالیت طلبیدن	ask for forgiveness
سر در کار خود بودن	to mind one\'s own business / to be busy with one\'s own work/business
جواب کردن	to reject,
خود را رساندن	to come running
جور بودن جنس	the line (of goods) is not complete
در بعد مقابله	in aspect of dealing with/taking action aginst [threats]
با کسی پدر کشتگی داشتن	to have a vendetta against someone
شهر هرت	zoo
برای خود بریدن و دوختن	One man Show
الاف بودن/کردن	to keep someone waiting/to be kept waiting
باش تا اموراتت بگذره	as you wish/ I don't care
دامن گستردن	spread to
تکلیف کسی را مشخص کردن	sort things out/ come up with a decision
نوبرش را آوردن	he/she has really gone too far
انگار نه انگار	doesn't care less/ doesn't give a damn
مزاحم تلفنی	Prank caller
خیر بودن	to be of Good Omen, blessings in the skies,
دل کسی گرفتن	to be down in the dumps
سرعت را بیشتر کردن	speed up
نرم افزاری در تامین امنیت،	software (methods/techniques) in providing security
شب شما بخیر	good evening; good night
توی شکم مادر	in one\'s mother\'s womb
مدیران جایگاه های 18 (سرتیپی)	Commanders/Officers holding rank 18 (Brigadier general)
زمینه ای موردی	Context for case study
خبر فوری	breaking news
آش پشت پا	bon voyage soup/ash
شر خر	collection agent
از رده خارج بودن	out of style
استوک	cleat; stud
کار کسی بیخ پیدا کردن	to reach a dead end
مگه پول علف خرسه	money doesn't grow on trees
چشم و هم چشمی کردن	to Keep up with the joneses
به اِزاي	against/per
ادا شده	pronounced
به غلط کردن افتادن	to pay the piper
پدر کسی را درآوردن	to fix somebody
سر کار گذاشتن	to pull someone\'s leg, to make fool/fun of someone
پای توی یک کفش کردن	stand pat, stand fast, stand firm,
از توی حلق کسی کشیدن بیرون	to make sb regret st
با هم گرم گرفتن	to treat warmly, to behave cordially/friendly
جور کردن	to get together
دل کسی باز شدن	to feel at ease/to feel comfortable
بلوز یقه کیپ	turtleneck blouse
کت دوطرف دکمه دار	double-breasted coat
استخاره کردن	to resort to bibliomancy
از دل کسی درآوردن	to make it up to someone
قربون ... رفتن	you deserve the Nobel Prize for....
امضا دادن	autograph
برای رد گم کردن	a red herring
جرم کسی سبک تر شدن	to reduce the charges against someone
یائسه	menopausal
قوز بالا قوز	kick in the pants
مرکز آموزش های تخصصی افسری(نیروی دریایی)	Specilized Naval Training Centre/ Marine Officer's Specialized Training Centre
دستش را گرفت لبِ ديوار.	catch the parapet
کم آوردن	to come up short
چیزی را در جیب خود گذاشتن (اصطلاح)	he eats \xyz\ for breakfast
ناودان	cullis, spout
در کمال خوشحالی	(It is) with great(est) happiness that...
خود را به موش مردگی زدن	play possum
مسخرشو درآورده	he/she has turned it into a circus
نظم دادگاه را رعایت کردن	order in the court!
مرده خوری گل زدن	to score an easy goal
بچه محل	homey/ home boy
پرکن	filler
هواگیری کردن	bleed
گوشه و کناری	somewhere, here and there
ثانی ها	the Thani family; the Thani clan; the House of Thani, the royal family of Qatar
جسم گیری	incarnation
معانی جزئیه	partial meanings
قانون هدفمندسازی یارانه ها	targeted subsidy/subsidies Law/ Act
با کسی طرف بودن	to deal with sb
ویژه‌ی سواری	a riding-only (camel)/ for riding
آشِ كشكِ خالَتِه، بُخوري پاته، نَخوري پاته.	You must grin and bear it./ Love it or leave it.
كار گروه تعيين مصاديق محتواي مجرمانه قانون جرايم رايانه اي	Committee for Determining Examples/ Instances of Criminal Web Content
کارنامه	filmography
به هم خوردن	To disrupt
کوری عصاكش كور دگر شود	(A case of) The blind leading the blind
بتکده	house of idols
در صحنه بودن	to actively participate in national affairs/to be ready to deal with any problem menacing the public interest
به جان هم انداختن	to set people against each other (to cause to become enemies)
به جرات	undoubtedly
تمام سرد و گرم های	all the ups and downs
توده لبوله	lobulated mass
برابر با	concurrent /simultanous with
(ترانسفورماتور (ترانس	Transformer
متفرقه	sundry fields
واژگان بینابینی و بی مورد	neutral and not applicable (N/A)
سابقه فرهنگستان در واژه سازی دورگه	background of (Persian Language and Literature) Academy in coining hybrid words
حد نصاب	quoracy
غائبین	apologies
به کل	in its entirety
دودوزه باز	double-crosser
حریم رودخانه	riparian zone or riparian area
تخریب اسناد و مدارک	spoilation of evidence
در نفی	in rebuttal of
ارزه	[I mean] That/the foreign currency.
آدم کشی	foul play
همه کارو ردیف کردن	to make/get things right
بويي از چیزی نبرده بودن	to be devoid / void of sth / to not understand / appreciate / realize sth
جام جم در جام	Jamejam dar Jam
شرح های معروف	established commentaries
دفاتر رسمی پلمپ شده	sealed ledgers
کوچک انگاری	belittlement
تفرعن	haughtiness / arrogance
صفات ثبوتيه و صفات سلبيه	affirmative and privative attributes of God
دولت‌شهر	city state
خودگردان	autonomous
دتکون بخور	move!
تدقیقات	Research
مصارف غذايي انسان و دام	human and domestic animal food consumption
بازیگردان	casting director
فروشگاه ابزار و يراق	Tools and Hardware Store
تحت سیطره در اوردن	to gain supremacy over
تايروترون	thyratron
یکجانشین	non-nomadic
کارهای اصلاحات منتهی به مهلت	corrections (to be) done before the deadline
سرردکسیای علمی انسکلوپدی تاجیک	Tajik scientific encyclopedic credixia
ریاست تنظیم کار مطبوعات و موسسه های طبع و نشر	head of regulating the press and publication institues affairs
فهرست نویسی	Cataloging
محله های زاغه نشین	slums
آلونک نشینی	Spontaneous Settlement
حاشیه نشینی	marginal settlement
کپر	farm shed
حلبی آباد‎	shanty town
فضولی موقوف	keep your nose out!
تا خرخره خوردن	eat to heart
پایگاه‌های اطلاع رسانی رسمی	official informational sites
استانداری	Provincial Government
هدرور ورودی میترینگ	(the) header side of the metering inlet
مشکل خواننده و مخاطب	the problem of readership
الکی خوش	a happy-go-lucky sort of person
مشکوک می زد	to look fishy
عذر خواستن	to discharge somebody
وعده سر خرمن دادن	to promise the moon
در مقابلم	before me/ in front of me
یا سر می‌رود یا کلاه می‌آید	Either to win the horse or lose the saddle
مطروحه	sub judice ; under judgement
ظاهر‌گرایی	appearancism
حاشیه نویسی	annotation
بالیدن	flaunt
چشمی‎	peephole
پر چاله و چوله	full of potholes
يا رومي روم، يا زنگي زنگ	either totally Roman or totally Zanzibari
اصلاحات امانی	Reforms of Amānullāh Khān
حق التالیف	royalty
می‌ذارم سر ما	to outcry, to scream as sloud as you can
مصوبات	enactments
بابری	(from) Babur/Baber/Babar or Baberi
ميدان تاخت و تاز	battlefield/ battleground
تست ورزش	cardiac stress test
تفاوت غذای رژیمی	extra charge for diet meals
اکومری	Trans- Esophageal Echocardiogram
پریکاردیوسنتز	pericardiocentesis
بازتوانی قلبی	Cardiac Rehabilitation
آنالیزوپروگرمینگ پیس	Pacemaker Analysis and Programming
آرتلاین و کاتتر سی وی پی	arterial line and CVP catheter
کاردیوژن الکتیو	Elective cardioversion
بابی یافتن	To find an opening (opportunity) toward/onto something
کباده کش	athlete / sportsman / gymnast /
خدمت رسیدن	to come over
حلال‌زاده بودن	speak of the devil and he appears
علی‌الحساب	down payment/ on account / in part payment
باور به عدم اطلاع	certitude of (author's) unawareness/ ignorance
خروج ارز	outflow of foreign currency
گلوله مشبک کاری	Perforation bullet
تطبیقی‎	adaptive
فیزیک لایه های نازک	Physics of Thin films‎
تاریخ امامت	History of Imamah
آزمایشگاه نور هندسی و موجی	Physical (wave) and Geometrical Optics Lab
رشته کردن پنبه / رشته ها پنبه شدن	put all (their) efforts in vain
ته دوزی کردن	stitching
سوله کارگاه	Soule (trade name for a metal building company) workshop / industrial shelter
از سردار	From a place situated in Multan, Punjab, Pakistan.
دانه‌ریز	small grain
پشت زدن	set-off
به دور	around the knitting needle
تاریخ ثبت سرنخ	thread registration/record date
مدير بازرگانی	business manager
خاصیت تنافر	repulsion
اوزالید	ozalid
تهویه هامون	Hamun Ventilation/Air Conditioning (Company)
وزیری‎	octavo
سلطانی‎	Folio
خرج	(Explosive) charge
زرنگار	Zarnegar
حروف‌نگاری شده	typeset
مدارس نمونه دولتی	State/Public Exemplary schools
در کنار	along with
کتابشناسی	bibliography
فراپیش گذاردن	to offer, provide, present, propose
وامی داشتن	force/compel; induce, persuade
با اعتبار	sponsored by
intangible	اموال غیر عینی / اموال معنوی / اموال غیر مادی
مستعجل‎	interim
سرانه فرهنگی	cultural spending per capita
علوم پایه	Basic Sciences
از محل	from/on the credit/funds
حفظ کیان	to protect the nature/essence
اعم از	including, such as
ستم‏کشی	submission, submissiveness
زیر پا گذاشتن	To walk over, to trample
در همين فاصله	meanwhile, in the meantime
گلايه‌گونه	complaining
حاميان	advocates, supporters, backers
حماسه و مقاومت	bravery / courage and resistance
بلوک پایه	cornerstone, groundwork, fundament
حال کسی را گرفتن	wear (sb) out/exhaust/shatter
مامور مربوطه	the (related) officer
مقیّد	committed
ماجراجویی کردن	to look for adventures, to set off on adventures
از باب مقدمه واجب	regarding the prelude to the obligatory
درخواست امان	seeking security or agreeing to a convenant
کوچه بازاری	Street Farsi
رض	May Allah be content with him
بر خر مراد سوار شدن	to reach the goal
مهذب الاسماء	An Arabic Dictionary: 18th century
پُرِ پُرش	latest / by the latest
چیزی نمونده	almost about to
لبیک	compliance, reply
پایین کشیدن	To shut down
جریان برانداز	subversive group/event (lit. subversive current)
خارج‌ نشین	living abroad / resident abroad, expatriate
سرعت مطمئنه	Safe speed
گره خوردن	to be tied to, to be accompanied by
تخلیه هیجان و شادی	(emotional) catharsis
دوره تخصصی پزشکی	Specialized (Medical) Program of Studies
گواهینامه پایان دوره	Certificate of Completion
معرق کاری	Mosaic tile-work
كلافگی	restlessness; a busy or occupied mind
نم نمک	slowly, little by little, bit by bit, sip by sip
غبار غم	cloud of sadness / sorrow
بابصيرت	insightful
به جان خریدن	gave his life for/ sacrificed himself for- welcome with body and soul/ purchase willingly
باب شدن	start / turn into a norm / become typical of ...
بيش و زودتر	...more and sooner than...
جفت‌سم	Cloven footed
دانه درشت	big shot, key player, major player
همی گفت	was saying (older Persian)
خطوط خردايش	crushing/grinding lines
فرشته آبان	The Angle of (the month) Aban
از آن جایی كه	For, because, since
آبادانی زمین	the prosperity of the land
از بنده	from/of me
پنجه نرم کردن	to deal with
به خود گرفتن	to develop (a characteristic); to take on (a characteristic)
به نوعی از	in some way or another, somehow
لشکر کشی کردن	to launch a military campaign
برخوردی (کاملا) دوگانه	(completely) double-faced approach
فرازی	Phrase/saying; idiomatic or short pithy expression
(ره)	Allah's mercy be upon him
به سخنرانی پرداختن	to proceed to speak; to proceed to give a speech
صادر شدن	To be issued, to be granted
صداي کسی را در آوردن	Driving somebody up the wall
دختر شیرینی فروش	The Pastry Girl
به یک اندازه	equally, equivalently
خيز برداشتن	to be poised to jump into
نمای نزدیک	close-up
حکایتگر	indicating, suggesting
حل و فصل	resolution
حمومک مورچه داره	the (little) bathhouse has ants
قيمت كن	(go)check the price (elsewhere)
هامون بازها	Hamoon fans
تیتر یک	main headline, banner headline, leader (journalism)
جان به لب آمدن	to be at the end of one’s rope, to be fed up with something
دشمن درجه یک	number one enemy
به خود	to itself
smart office	دفتر/محل کار هوشمند
به اين تريتب	thus, therefore
به نحوی كاملا هوشمند	in a highly/very intelligent way
تورم‌زايي	swell/swelling (behaviour/characteristic of soil)
فقط سر من بی کلاه موند	only I was left without the shirt on my back
خوردگان	(the) defeated
كش و قوس	flip-flopping, hemming and hawing, waffling
گيرانداختن	to catch / be caught
گیر دادن	to betray, disclose
بيخ گوش	right under the nose of...
کم رنگ جلوه دادن	to present something as weak
در قالب	in the form of, in the shape of
چندان	(not) much
به احتمال بسيار قوی	in all likelihood, in all probability
نظر افكندن	to look, to cast a glance
بازاری	secular, profane, materialistic (lit. market)
عشق کسی را مي‌كشه	whenever someone likes/whatever someone likes
يادت باشه‌ها!	Remember!
روشن‌ضمیر	illuminato
اين شتريه كه در خونه‌ي همه مي‌خوابه	A camel that kneels before every door
فداي سرت!	dont worry/doesnt matter/never mind
شركت خدمات منزل	Domestic services
همچنان	still
مساعدت فرمایید	assistance with
اسکان	Accommodation
میتوان بودن	can be
وکیل پایه یک دادگستری	senior attorney-at-law/solicitor
شریک سهامی	corporate partner
به‌جا گذاشتن	leave (for others)
کشکول	Anthology
جزء لاینفک	integral/inseperable part of .....
گردش حساب سود انباشته	Retained earning cash flow
منتهی به	...ending....
مصاحبه	interview
انصراف	withdrawal
پرداخت به صورت اقساط	payment by instalment/ to pay by instalment
نماینده رسمی	authorized representative
خاک مهر‌آیین	Land of Mercy and Kindness
رنگ واره	colour shadow
پسرِ شاخِ شمشادي	lofty as a box tree
خانم	Ma'am
هو المولف بین القلوب	It is He who reconciles/unites the hearts
هرطور شده	however it happened/came out
با آرزوی موفقیت های روزافزون	wishing you ever increasing success
گیاه علفی	herbaceous plant
جور شدن	(I hope circumstances) permit/allow (you to visit Iran...)
جد اعلی	great grandfather
به گفته‌ی	according to/as stated by
چراغدار	Trailblazer / Pathfinder
عریضه نویس	petition writer
عجب آدمی هستی	you are really something!
عین خیالش هم نیست!	He doesn\'t care at all!
نهان بين	Knower of Secrets/Seer of Secrets
سوته‌دلان	Sooteh Delan
واژه گزینی	word choice/ word selection
آینده سازان جامعه	builders of tomorrow's society
آینه تمام نما	full manifestation
استلزامات تربیتی	educational obligations/requirements
ارزش شناسی	axiology
بازی دست شماست	the ball is in your court
به طور خاص	specifically
مفصّل	elaborate/extensive
حکومت هند بریتانیا	British rule in India
حیطه‌ها	boundries / limits / scope
از راه رسيدن	turn up/show up (from nowhere)
از شر چیزی خلاص شدن	get rid of
noomzadam	My fiancee
dampaiee foroosh	selling slippers / slippers seller
لج کردن	to dig heels in/ to be obstinate or stubborn
طی شدن	to experience
در مَثَل مناقشه نیست	don\'t quibble/argue over an example
زمین خاکی	start from zero
دست دراز بودن	begging
کشک سابی لبو	(wide-mouth) mortar and pestle
دادسرا	Public prosecutor's office
علامت غالب	major/main symptom
خط جغرافيايي	geographical line
لبه آتش	next to the fire
و بره	wrap it up
توابع اعیان مستحدثات	superstructure of the property with all the appurtenances appertaining thereto
مفاصا حساب شهرداری	tax clearance obtained from municipality/municipal tax clearance
تبدیل به چیزی گردیدن	convert
بر	on/at
دفتر ثبت شرکتهای خارجی	Foreign Companies Registration Office
موازی کاری	parallel work
احتراما	respectfully
کیف قاپی	purse snatching
دایره تجسس	bureau of investigation
مدیر پایگاه آگاهی	Head of Criminal Investigation Department
چمنزار	pasture/grassland/meadowland
محل استقرار قشر خدمتکاران	the area where servant class/stratum settled, the settlement of servant class
دلا ل محبت	procurer/procuress
برگه عدم خلافی خودرو	driving record/motor vehicle record
تنظیم سند	Prepare/draw up the deed
دگرباش	LGBT / GLBT
اينه جاي تشكّرت؟	This is what I get instead of your gratitude?
در عین حال	yet
یا بخت و یا اقبال	I \'m Feeling Lucky
ایرانیت	Corrugated Sheet
پیش خرید	Forward purchase/advance purchase
به عبارتی	in other words
جادّه	road
ساخته شدن	to grow stronger, to stand on one\'s own feet
هر چه بیشتر	increasing/increasingly
عدم تفاهم	lack/absence of understanding
صحت عقل	being of sound and disposing mind
به اجرا گذاشتن چک	to cash the cheque
ستاره ابر نواختر	supernova
در مسیرِ چیزی	Along the (Zayande River)
به کلام	the word
اسکیس وراندو	sketch(ing) and rendering
مثل پروانه دور کسی گشتن	flitting/fluttering around someone like a butterfly
قرار موقوفی تعقیب	decree/order for suspension of prosecution
ملاحظه شد	noted/duly noted
جهت اقدام مقتضی	For the appropriate action
bar khod hamvaar kardan	to take upon oneself/to bear
نظری	Theoretical
دوّمي	the second/latter person
آدم بی جنبه ای هست	you can\'t take a joke
مشاور مدير عامل	Advisor to the Executive/Managing Director
کاری می کنی کارستان	take the bull by the horns
کارشناس امتحانات	Examinations Expert
مرکز پیش دانشگاهی بزرگسالان	Adult pre-university school/center
فرزندسالاری	child-driven (society)
عصا قورت داده	affected
برآيند	resultant, consequence
جدّم	My progenitor / predecessor
هر چی از دهنش در اومد بهم گفت	he let loose with everything he had
خودی نشان دادن	to show off/ to flaunt
کوی	tomb
در پی داشتن	lead to/result in
خشکم زده بود	I was petrified/dumbfounded/stunned/astounded
هر چند وقت	every now and then, sometimes, occasionally
حالت گرایی	modalism
آک مخت به هم می‌خوره!	keep your mind brand new/virgin!
یه وقت نکنه دوزار فکر کنیا!	don\'t strain your brain
هتل بین راهی	roadside hotel/motel
فرا باشند	transcendence
حرف دل من چیه؟	what do I really mean
من خودم هشتم گروی نهم است	I am over a barrel
طرحی ساختگی	concocted/fabricated design
قسم مس دهند	swear
جمال بی نقطه ات رو عشقه!	your / I love / ...love it!
موفق به چیزی شدن	to succeed in (doing) something
به قولی	as they say
بادمجان بم، آفت نداره	A bad thing never dies/A bad vessel is seldom broken
اين حسن ظنّ شما رو مي‌رسونه	this conveys your favorable opinion
پاسگاه طالقان	Taleghan Police Station
اشو	Ashu
گره زمان	(childhood) dilemma
فصل‌بندي كردن	to divide (a book) into chapters
مراحم	Welcome
در سمت فرمانداری خوزستان	as the governor of Khoozestan
حالا چه خاکی به سرم کنم؟	I don\'t know the heck which way to turn
تهاتر	offset/compensated for
لایحه جوابیه	rejoinder
جلب ثالث	impleader
کد نظام پزشکی	Medical Council Code/Number
همینطوری	non-stop
صفر	zero mileage (Brand new vehicle)
settlement	تسویه حساب
ببینیم چی میگیم	(then) we will decide
قابل توجه	Attention:
عوامل بزه دیدگی	factors in victimhood
قاب‌بندی	fraiming
ظرفیت‌های نمایشی	cinematic potential/capacities
قفسه سینه	rib cage , thorax, chest
It\'s an ill wind that blows no good.	در هر شری خیری نهفته است/هیچ بدی نیست که نتوان در آن خوبی یافت
کنایه	figurative(ly)
مطالعات كالبدي	physical/structural study
دستگاه اطلاعات	intelligence service
ای بدک نیست	not so bad, eh?
این مایه افتخار ماست	It is an honor for us
خروس	sissy, timid
موجب جلب	(will) lead to (your) arrest
عجب از این تکنولوژی	What a technology!
كودكياري	Childcare
مقام معظم ولایت	The Supreme Leader
تجنی	تجلی گاه - the epitome of/ a place epitomizing
به طرفیت	against
نشر اکاذیب	spreading disinformation/lies
نقض	nullify/violate/infinge/breach
مضمون عنه	The principal
مضمون له	obligee
حامل های انرژی	energy carriers
فلفل‌ساب	pepper grinder, pepper shaker
رئيس دادگاه	Presiding judge
سو برداشت نشه خداي نكرده	(I hope you) won\'t/don\'t misunderstand me / don\'t misinterpret me
اعلام ختم دادرسی	conclusion of court hearing / the hearing
دادنامه	court (verdict), written judgment
بازی داره	is tricky or doesnt suit you
آسمان و ريسمان را به هم بافتن	cock and bull story
ریختن	add
تا سه نشه بازی نشه.	third time lucky
در حال تحصیل	presently studying
سیستم جامع دانشگاهی گلستان	Golestan Comprehensive/Integrated Academic System
مسئول امور فارغ التحصیلان	Officer/Director of Graduate Affairs
ارزشیابی درس	Course evaluation
گرایش رشته تحصیلی	(academic) minor
معافیت کفالت	Guardianship Exemption (from Military Service)
طرح	action plan
مانتو، کت و دامن	(outer) coat, ladies suit
از دادگستری اومدم	I am coming from/I am a memebr of the Justice Administration office.
دبیر کمیسیون نظارت و بررسی	secretary of monitoring and supervision commision
مراجع قضایی	judicial/legal authorities
درس خود بهره جسته بود	...sought to use (these rites) as his own class(room)
لخلخکنان	sluggishly
حالا كاريه كه شده!	What is done is done!
خب كه چي؟	so what?
محل بدهی	debit account/allocation
قیمت فروش اولیه سهام	initial (public) offering price
سرقفلی	key money
برداشتن	pick/choose
یه جورایی	Somehow
روشون بحث کردن	talk about, discuss
آخه من از دست تو چه کار کنم؟	What am I supposed to do with you?
این طرف‌ترش	a bit more to this side (of it)
ریال	Rials; IRR
بازپرس شعبه	Branch interrogator; branch prosecutor
پلاک فرعی	sublot
ایرو	IRU (International Road and Transport Union)
سه دونگ سه دونگ	fifty-fifty/even-steven
روز افزون	ever increasing/ever-increasing
حالت شهود	having a vision
نمرات تطبیقی	Comparative Marks
اسباب تحقیقیه	investigative tools/equipments
مافی الذمه	obligation
آنات	Samples / Instances
مورد صلح	transfer
شرکت نسبی	Company with Proportionate Liability
تمن مبیع	slaes price
قول سر خرمن	a pie in the sky promise
تا تو باشی منم با خودت می‌بردی	let that be a lesson...you should have taken me with you
دلم پوسید.	I feel (very) gloomy/melancholy
هلاک	to die for sth
معاون بازبین اسناد	Document Review Assistant
خارج از دستور	impromptu/ out of the box question
نشنیده گرفتن	to turn a deaf ear to
انگار از دماغ فیل افتاده	Think one is God\'s gift to mankind
باره	extremely eager and interested/lover/avaricious
گزارش تصویری	slide show
دفتریار دفترخانه	notary public assistant
شماره ثبت دفتر	Notary public office registration number
سردفتر	notary public
معرفین	references
وکالت بلا عزل با توکیل غیر	an irrevocable power of attorney, with right of substitution
گواهی عدم امکان سازش	certificate of incompatibility
چاله خركشي	Kharkoshi slum
تقدیرنامه	award certificate
از وسط نصفت كنه	cut you in half
تحویل دادن اتاق	Check-out
مجوز امنیتی و حراستی	security and safety permit
موسسه مطالعات بین المللی انرژی	Institute for International Energy Studies
عضو هیأت علمی موسسه و مشاور امور اجتماعی و توسعه پایدار	Scientific Board Member of the Institute and an Adviser for Social Affairs and Sustainable Developme
مجری طرح	Project executive
در قبال	against
به‌دست	through, with the help of
آزموده را آزمودن خطاست	once burned, twice shy
براي هفت پشتم بسه!	enough for a lifetime
موند، که موند!	still tasted the same!
مرگ حقه	death cannot be denied
مالرو	bridle path/road way
به جان کسی/چیزی افتادن	attack sb/sth, gang up on sb/sth, sail into , take the offensive
خوره	canker, leprosy, parasite
طبق پراید- فولی میل لنگ	crankshaft pulley---Pride (steering) control arm
توپی چرخ	hub
خواستن	will/ is gonna/is supposed to
نوازشگر	caresser/soother
معنی جای میدهد	\means \'a place\'\
به چشم آمدن	to attract attention, to be conspicuous
گواهی مآمور ابلاغ	process server's witness/testimony
دادگستری جمهوری اسلامی ایران	Ministry of Justice of the Islamic Republic of Iran
چندمین	which
زماندهي	timing / time-table
دارم گور خودمو می‌کّنم!	I\'m digging my own grave
دست دست کردن	dilly-dally
تش	علم) تشریح)
از نوک دماغ کسی درآوردن	killed the joy / spoiled the moment / spoiled my mood
آبادگر	developer(s)
سازمان آموزش فنی و حرفه ای	Technical  Vocational Training Organization
ارکان	pillar
کم کردن سهام	to reduce/decrease the shares
بازم همون آشو همون کاسه	It\'s the same old story
در چشم باد	In the Wind\'s Eye or in Wind\'s View
دنیا بگو بهش، مگه گوش میکنه	No matter what you tell him, he won\'t listen
خاموش ایستادن	They stood silent
بواقع	In fact, really
شورا بی‌شورا	No Council/ Morons
سنجش از دور	remote sensing
قوادی	To pimp
روشنايي بخش راه	path illuminator
رال قاعده ای	basal rale
برنامه‌ی روشنا	Program of Luminosity
زورم بهت نمی‌رسه	I\'m no match for you/I can\'t touch you
فلزش خراب است	bad to the bone
خرخونا جای خود دارن!	not to mention crammers/crammers have their own special place
فرهنگسازی	culture-building practices, cultural domination practices
دمِ صبح	dawn, early morning
کافو	service area interface (SAI), B-box, cross-connect box, cross box, ped, pedestal, access point (AP)
زورگیری با شوکر	assailant with taser/stun gun
( امام ( ره	may God bless him
سالنما	Diary
آشتی بی آشتی	forget about reconciliation
حظ کردن	your eyes will light up
سر آوردن	doing an important or difficult job
بستن نطفه	conception
ذیحسابی	accounting
معاونت بهره برداری	Operations Department
منشور اخلافی	code of ethics
اطّرفی	on the other hand, besides, moreover
شبکه مهر ایران و ایرانی	Iran and Iranian\'s Mehr Network
بناهای این شکلی	buildings like these
ته‌مایه	trace
ناپلئوني	scraping through by the skin of one\'s teeth (as suggested by original poster)
زر با زور	you can\'t hold me to ransom
با کمال میل	with pleasure, willingly
خوشغیرت	The Hard Ride
اصولگرایان	Fundamentalists
جان به در بردن	survive
تابعی از ضرایب یک ماه	(will be calculated as) multiples of the one month rate
ساختار ذهنی-فکری	mental-intellectual structure
نمی‌خواهد نگران باشی.	There\'s no need / you don\'t need to worry
قابل جمع بودن	co-exist, coexistence
تا جایی که	to the extent that / as far as
هر طوری هست	at all costs
خیلی زود کم آوردی	you gave in too early/very quickly
از کی گوش دادین؟	Whose songs have you listened?
حق و حقوق	rights and dues
دارم برای خودم تو اینترنت میچرخم	I\'m surfing/messing around the Internet just for the fun of it
دفتر مشق	Life Office / Office of Life
هر عشقی تاوان داره	Every love has its price
مرزشکنی	boundary breaking/frontier crossing
اسکلت بندی	frame
سرش را انداختن	(to) droop one\'s head
لاي جرز	be a waste of space
یه وقت	if/whether
زمین انسانها	The land of humans
آماده‌خور	sponger/freeloader
خب این چه کاریه!	What\'s the point/idea of that?!
درآمدن	to come under/into ...
بچه‌ی نیک روزگار	one good fellow/folk
barghi	electric/shiny
خوش رکاب	easy/sweet/smooth ride
حالا خوبه	It\'s a good thing that...
چطور مگه؟	How come?!
تک خال	ace
هم خدا را می خواهد هم خرما را	He/she wants to have his/her cake and eat it too
دست نمی‌دادش	I didnt have a good feeling about it
بار فردی	individual/personal responsibility
زندگی مسیح گونه	christ like living
در مقابل	as opposed to
از شما جه پنهان	to tell you the truth
دست بردار نیست!	to give up doing sth/ to give it up
یکبار برای همیشه	once for all
عروسی به هم خورد.	the wedding was called off/got cancelled
بهتر از همیشه و گذشته	better than ever before
با گذشت این مدت	during this time
از جمله من	including me
Shoor Nadari	you don't have any common sense
سَنْگَر	sandbag fortification
نماز جماعت	congregational prayers
سالک شدن	to become a walker
در پیش گرفتن	(to) take the way to / (to) head to
خوار و بار فروشی	grocery (store/shop)
محیا کردن	prepare, provide, make ready
خانهواده‌دوست	family-loving
دست روی دلم نگذار که خونه!	Don\'t try to console me!
اصغرم که اینجاست	Asghar is here too
وایستادن به چیزی کردن	to stand there doing something
امور اجرایی طرح های آب	The executive affairs of water plans
دفتر وصول درآمد	revenue receipts office
دفتر مدیریت مصرف و کاهش آب بدون درآمد	The Office for Consumption Management and Reducing Non-Revenue Water (NRW)
بر زبان راندن	(to) speak
این وسط	in this situation , in all this
چه وضع تعمیر ماشینه!	What kind of repair job is that?!
دبی ورودی	inlet flow
اجرای خطوط انتقال آب	implementation of water transfer lines/ pipelines
هیآت احتسابی	Sharia/religious enforcement committee
مأمور بدرقه	prisoner transport agent
تنظیم اجراات	enforcement regulation/organization
Documents	اسناد؛ مدارک
دوزار بده آش، به همین خیال باش.	Dream on!
آقازاده	aristocrat/aristocratic
کازو	Peanut
امر به معروف و نهی از منکر کردن	to promote virtue and prevent vice
آیینۀ خدانما	God- reflecting mirror/ Divinity- reflecting mirror/ God- showing mirror
کندوان	Kandovan tunnel
داد کسی را ستاندن	grant sb justice against his or her adversary
سند بردگی یوزارسیف	Yuzaarsif\'s slavery document
شار حرارتی	thermal flux
یه دستی زدن	finesse/outwit
فرورد	produce
او را بهتر آن می‌بود	It would be better for him
درافتادن	land up, end up
کاردانش	Vocational Training (Branch)
از این گذشته	furthermore
عزیزمصر	Beloved of Egypt
حالشو میگیرم	I\'ll show him, I´ll teach him a lesson, I\'ll give him hell
در کوچه پس کوچه‌های شهر	in alleys and back alleys of the city
مسیحی نشین	Christian
درست حسابی	decent
ساز و آواز	music and singing
بگفتا	said S/He
هیچی حالیش نیستا!	doesnt have the foggiest/faintest (idea)!
steal past the watchful dragons	دزدكی از زير نگاههای تيزبين رد شود
بسوزاند	to be filled with compassion
همه زدیم زیر خنده.	burst into laughter, burst out laughing, break into laughter, guffaw
با کلّه خورد زمین	he fell flat on his face
كه سهله	not only
سامان	Land/Region/Area/Village
در اینباره	about this matter
کم و کیف برخوردهای اخیر	circumstances of recent encounters
مقرر گردید	It was resolved that/It was decided that
صیغه طلاق / ازدواج	Divorce / marriage pronouncement
مهریه / جهیزیه	marriage portion (settlement) / dowry
اجرت المثل	reasonable wage/compensation
طلاق خُلع	Divorce with compensation from wife
دور	turn/spin
حقطلبی	Truth-seeking/ seeking the Truth
پزشک معالج	Rendering Physician
رگ حیاتی	life line
خراجگیران و گناهکاران جملگی	all land tax collectors and sinners
Modir e Omoor e Eghtesadi e Chand Janebehye Vezarat e Omoor e Kharejeh Iran	Director of Multilateral Economic Affairs, Ministry of Foreign Affairs of Iran
پروانه کسب	Business Permit
آدم زورش می گیره	that burns me up
برآورده کنید	Have (my last request) granted
سرپایی	ambulatory / outpatient
کارستون	marvellous, unique, eyecatching
جعاله	contract of reward
زبان‌زد	proverb
رئیس مجمع	head/president of the council/assembly/board
صندوق های قرض الحسنه	interest-free loan funds
سازمان جانبازان انقلاب اسلامی	Islamic Revolution (disabled) Veterans Organization
...آزادسازی نرخ سود بانکی و مرتبط کردن آن با	Deregulation of bank interest rates and linking it with....
نبش	on/at the corner of
با داشتن درک صحیح از چیزی	...having a correct understanding of something
این وسط گناه من	What did I do to deserve this?
طالب كه به ظاهر ديوانه‌كوچه گردي است	Taleb who is apparently an alley-wandering lunatic.
هول و ولام	tenterhooks
سه حلقه دی وی دی	three DVDs
قُل	A single unit
به مُرده که رو بدی، کفنش را نجس می‌کنه.	Give him/etc. an inch and he\'ll take a mile/yard.
در دیزی بازه!، حیای گربه کجا رفت؟	Honest as the cat when the meat\'s out of reach
در بند حرف و یا افکار دیگران بودن	To be bound with other\'s opinions / ideas
شش دانگ	all the six portions/the entire lot area
روی خود را زیاد کردن	to go too far/to overdo it/to push it
به بختت لگد زدی.	you messed up your chance/opportunity
یهو	all at once, suddenly, all of a suden
اين‌ور و اون‌ور كردن	to move/toss/turn/etc. something around
صاحب کرَم	benefactor
کول	atop the shoulder
به نقل از	quote from/according to
سر بچه‌ی من داد زد	He yelled at/ shouted at my kid
پایگاه	database, portal
دیرکرد	overdue (amount/payment)
بیعانه	deposit
سایه چو شمع شعله در افکنده‌ایی به جمع	\'Sayeh\', thou like a candle hast thrown flame to the throng
اد	عدل / exact
از	one of the
حرمت نگاه‌دار اگرش نوش میکنی	Don\'t indulge if you drink; observe if you drink; respect the norms if you drink
مختارنامه دانلود	Mokhtaar Nameh (The Stroy of Mokhtaar)
توک	for a moment, for a second, for a short time
با که دست در آغوش می کنی؟	Whom are you drawing into your embrace?
درآمد حق الثبت	registration fee (income)
بروی	on the ..
دل خوشی داری‌ها!	nothing phases you, huh?
شرح خبر	Details of news
توليد	production
به زور زحمت	by force / hardly / barely
سوخته	opium dross
هرچي سنگه، مال پاي لنگه	Flies go to leant horses
Daro duff	hot babes/chicks
من چه کاره ام؟	(So) what\'s my role (then)?
كلي منظره زيباي بين راه	(you\'ll miss) all the beautiful scenery on/along the way
قنوت کردن	to supplicate
عبا به سر کشیدن	hunched under a wrap/cloak
منبت معرق تلفیقی	combined mosaic marquetry
داستان «شب دهم» آمده است	In summary of The Tenth Night it is mentioned
روی آنتن رفتن	air
همت گماشتن	to endeavor/to try hard
سرمه كردن	kohl
کار نیکو کردن از پر کردن است	Practice makes perfect
رو بورس	fashionable
پخش مجدد	rerun
راه باز، جادّه دراز	Go ahead, see if I care!
بهم ساخته	conjoin
مسئول تداركات	preparations officer
در مقام تحقیر	derogatory
یه وقت	never / don\'t even think about...
شاهنامه آخرش خوش است	All is well that ends well
گ.ش.	گیاه شناسی
دقت‌نظري	Meticulous attention
سنجي	being meticulously observant - meticulous
استعداد یاب	talent scout
به ويژه آنكه	especially that , especially given the fact that ...
گنجانه	container; vessel
ترنابازی	towel snapping/rat-tailing
به دو پول سیاه	stiver
رسمش	the way (it is done)/the custom
تاریخچه زمانی نیروی محوری دیواره	timeline/time record/time history of the wall/rim\'s axial force
لنگر خمشی	bending moment; flexural moment
میرایی رایلی از نوع سختی	Riley damping, hardness type
میرایی هیسترتیک	hysteretic damping
شبکه تفاضل محدود	finite difference network
المان تیر	the beam element
شرایط مرزی در دیواره ها	boundary conditions at the walls/rims
گامهای زمانی متوالی	at sequential/continuous intervals
شرایط کرنش صفحه ای	under plain strain conditions
Beggars can\'t be choosers	گدا را چه به چانه زدن
از مال پس است و از جان عاصی	He/she is in no mood.
to invade a country	مورد حمله/تجاوز قرار دادن یک کشور
حكومت رضاخاني	Reza Khan Pahlavis\' Regime
تلفن بيسيم	cordless phone
دور زدن	double cross/pull a fast one
این شمشیر را بر گلویش کشیدی؟	Did you cut her throat with THIS sword?
آخر قصه	in the end/at last
اموال و ضغیر غائب	trustee/guardian of an absent and missing person\'s assets and minor child/children
کنین	do, perform
عاقبت زیادخواهی	the wages of greed
privacy policy	سیاست حفظ حریم خصوصی/شخصی
جلوه و شکوهی خاص را به این نمایشگاه می¬بخشید،	bestows particular/special glory and honor/significance to this exhibition
احکام نجومی	Astronomical laws
متوجه او	threatening him
تاج و تجت	crown and throne
امامزاده	(holy shrine) of an Imam\'s Descendant
صرفا	Only / merely
مخازن	resources, sources
ایشیک آقاسی باشی	Grand Master of Ceremonies
همایونیمان حال آمد. پدر سوخته	Our Highness was/is amused, you bastard!
زنگ تفریح	Break / Playtime
خاصۀ شریفه	special and noble
حساب حسابه كاكا برادر	bussiness is business
به شمار می‌رود	is considered
haghighat zendegi	the truth of life
دست به سر كردن	get rid of / send away
خوش‌نشین‌ها	carefree dwellers/livers
چشم ديدن کسی را نداشتن	not to stand the sight of sb
مرشد اکمل	the most perfect perceptor/ teacher
کد بستی: 12345 ش اق	Economic Code/Number - Zip Code/Postal Code
متد تک قیچی	single-scissor method
که	Therefore you shall live!
با خاک یکسان کردن	to rase / To make level with the ground
تعاملی	interactive
بازی روزگار	the games life plays!
بدست آرد دل ما را	take my heart within her hand ...
دست و پا گیرت شده بود	[My unreasonable love] seized you up -beacme a burden- captivated you
بچه دار شدن	to become a parent
آش با جاشه	to take the bad with the good
مناقشه	controverse, discute, debate
پرانتزباز	Open parenthesis
نقش	relief
ارزیابی شکلی	evaluation/assessment of (bid\'s) responsiveness
ميزان دوستاشتن	degree of love
حکم کارگزینی	earnings statement
فوق‌العاده برجستگی	good performance allowance
به مثابه یکی از حوزه های پیرامونی امنیت ساز	As a security-building neighbor/element in the region
کشورهای منطقه	countries of the region / region countries
مدگرایی و قنداست زدایی	fashionism and desanctification
خطوط تغذیه	feed/feeding lines
برای روز مبادا	for a rainy day
در ارتباط با	Connected to / Related to
بازار مشترك	Common Market
دفاتر مهمه	important/vital dossiers/ledgers
علوي گري	Alavism
مرور	review
لنگ كفش كهنه	an old shoe
گربه کوره	ungrateful/literrally blind cat
آناتولي	Anatolia
خدمات جانبي	Secondary services
هلاک جرعه ای آب و اسیر لقمه ای نان است	dying for a sip of water and struggling for a morsel of bread
به خودت برس	Take care of yourself
ندارد ناخدایی چون به کشتی اندر این طوفان	Since he has no shipmaster on the ship in this storm ...
قتل عمد	first degree murder
کارفرما	Outsourcer
ابلاغ کردن حکم اداری / نامه ی اداری / رأی دادگاه	serve sth on sb
به درستی	appropriately/ properly
خبرنگار اعزامی واحد مرکزی خبر	Central News Unit\'s / Agency\'s on-the-scene reporter / correspondent
فتح قله	To reach the summit
خون دل خوردن	To eat one\' heart out, to suffer very much in silence
چك تضميني	guaranteed check/certified check
موارد	instances
برآن بودن	has tried to, has saught, has been up to
آنجلس	Anjolos Mountain
زیر هشت	under the vestibule
سنگ خاره	very hard rock /granite
سلامتی کلیسا	for the health/happines/ well-being of the community
همزاد	doppelgänger/evil twin
مورد یك حادثه	This case was an accident!
نوكیش	convert
حقوق مادي و معنوي	material and intellectual rights
در حال حاضر	for the time being
كم دوام بودن	low durability of
در اختیار کسی گذاشتن	To provide sb with (more) information
ناجور	unpleasant
تماشاگر نما	hooligans
ضربه گیر / ضربه پذیر	[Shock damper/bumper] / [Shock resistant]
نشست سنج	settlement tube/settlement meter
سگ زرد برادر شغال است	as bad as another
حله؟	That\'s ok!
مقامات بالا	superiors
نشانوند ساختگي‌	dummy argument
مسکن	sedative
از خود بی‌خود شدن	(to be) out of it/(to) lose it
در عالم خواب و بیداری	semi-conscious (state)
ثنایی/ثنائی	ثنا means worship/exaltation
پته كسي را روي آب انداختن	to spill the beans, to air someone's dirty laundry
آنها بچه ها را میفریفتاند و به کارهای بدو میداشتند	They decieve/mislead children and force them to bad things
گر صبر کنی زغوره حلوا سازم	all good things come to those who wait
پیش بگیرم	to follow the path of God
عوام فریبانه	demagogical
هم صحبت	conversationalist
محراب / عبادتگاه	Mihrab
ساقی	cup-bearer
پلاک	dog tag
با خودم تعارف ندارم	I can\'t kid myself
شهرک	town
منطقه‌ی دربند	Darband Area/Region
تدوین نهایی شدن	final editing
سراشیبی	(downward) slope
میخانه	tavern
پای تو گیــره	stuck on you
مطبوع	Air conditioning
فوتبال زدگی	disenchanted with football, disitnerested in football
در دادن	to call / to proclaim
بزرگمرد	great man
وقت	appointment
تو خیلی بیخود میکنی	What the hell gives you the right to do that?
قات زده	lose one\'s marbles , go bananas
دو صد چندين و چندان	200 multiplied
از آن روست که	is because
گرفته	full of grief
بقیةالله اعظم	It is a title for the twelfth Imam himself, meaning \The Holy One Who endures with Allah\
! او فکر کرد که مرغ دوستش یک پا دارد	he thought that his friend is pig-headed
اگه من با خودم سردم	If I am not happy
مورچه چیه که کله پاچه اش چی باشه	You are far too insignificant to even think about such a thing!
دلشوره	anxiety, uneasiness, apprehension
خفت‌بار	humiliating
آدمفروش شادمهر	Shadmehr - Betrayer
جانانه	massive
غرولندو	scold
What have you brought on yourself?	چه بلایی سر خودت آوردی؟
بادش ميدهد	blows it/آن را باد می دهد
بستر سازی کردن	lay the groundwork
بوجار لنجان	time server
نیرو گرفتن	empowered by
اگر گربه بال داشت همۀ پرندگان را توی هوا می‌قاپید	If the cat had wings, it would choke all the birds in the air
طی آن	\according to which\
دور ایستا	standoff
مردمی	popular, public
پر نقش و نگار	ornate
از روی تمسخر گفتن	(to) say in a derisive/mocking/ridiculing way
پیش دستی کردن	to steal a march on sb
سر از جایی در آوردن	wind up somewhere
!نی نی شلوغکار	noisy little one!
موقعیتی	situational
روش	way/method
پَرِ‌کاهی	a stubble / a small straw
دهان به دهان گشتن	spread mouth to mouth
جا انداختن	miss
ارباب انواع	owners/masters of kinds/varieties
برهوت	wasteland
خنده‌اش گرفت	burst out laughing/burst into laughter
گویا	expressive
حوضچه آبگیری و آب اندازی شناور ها	boat/vessel docking and launching basin
شناور کروبوت و شناور تندرو	crew boat and high-speed vessel
کاغذکشی	crepe paper
در پس آن	behind it
به جان خریدن	willingly tolerate/put up with
راه را اشتباه رفته بود	had gone wrong (to go wrong)
جاگیر شدیم	Settled down
نازل شدن آیه	revelation of a verse
قلم	Reed Pen
منت نگذاشتن	not to lay under obligation/ not to confer an obligation upon somebody
جفت کردن پا	put one's feet together
حسابی	adj:good/real _ adv:really/liberally/well
دل خواستن	like, want, would like, desire
بالای تپه	top of the hill
در تاریک و روشن هوا	in the twilight
شایعه‌پر اکنیها	gossips
جام طلایی	Golden cup
همزمان با ولادت پربركت مولاي متقيان اميرالمومنين حضرت علي عليه السلام (ع ا	On the auspicious occasion of the birth of the lord of all the pious, Imam Ali (Peace be upon him),
پیش روی داشتن	to be going to face
نکته زیانباری	harmful point
هرچه باشد	after all
از خود	express more excitement
عمدتاً	mainly, chiefly, generally - مسیحی مصلحتی for \rice Christian\
به سخن آوردن	Makes the book speak
استناد	according to/with reference to
نازیدن	to glory
کلاه تقی سر نقی گذاشتن	to rob Peter to pay Paul.
بافت فرسوده	worn-out/time-worn textures
اولین کنفرانس بین المللی مطالعه ساخت و ساز شهری در مجاورت گسل های فعال	The First International Conference of Urban Construction in the Vicinity of Active Faults
سر را هم بود	I had another problem (in my way)
مشت با درفش زدن	doing sth in vain
پرستد مردگان را گه	idolize the dead people / worship the dead people
تهمتـــــــن	second to none in physical largeness and stature
نرم‌افزار	Software
انوشیروان	Anoushiravan
اکبره پیداش نشد	Hasn't this lad John turned up yet?
به باد کتک گرفتن	inflict a torrent of/ torrents of/a shower of blows on
راهکار	solution/method/practice
دور هرمنيوتيك - امتزاج افق ها	Hermenutical circle - Merger of horizons
تدوين برنامه نظام مند آموزش كاركنان واحد پذيرايي هتل هاي 5 ستاره	the compilation of systematic training program for the serivce personnel in five-star hotels
آب غوره گرفتن	To cry bitter tears
خبرسازترین حادثه فرهنگی	the biggest news-making cultural event
خلیفگی	caliphship, successorship, representation
محجوبه	covert
سلطنت	realm
گرایانه	-oriented
طراحی فرآیند آموزش نظام مند کارکنان هتل بر اساس استاندارد	designing a systematic process for training hotel staff according to the standards
zolf parishun	Disheveled / Wind blown hair
هریک با رویکردی متمایز	each one with its own distinct approach
صیرورت	becoming
وی‌یه	وی: he/she (or him/her)
نقطة عزیمت	departure point/starting point
متعاليه	transcendental
انفطار	dichotomy
حق ناودان	right of easement
اسقاط کافه خیارات	waiving all options
عرضه و اعیان	Land and Building
یک باب مغازه به مساحت بیست و پنج متر مربع بصورت سرقفلی .....اجاره داده می شود	A store, with [total] area of twenty five square meters, is leased ........for key-money
بر بر خورد	clash / struggle / confrontation / conflict with...
متعهد	committed / pledged
بپردازد	to condemn
chand ta kam dari	how many are you short?
واحدهاي تطبيقي شاخه نظري ضمن سال روزانه اول	units compared and accepted for the theoretical branch of grade-one yearlong daily courses
صوفیان بازاری	common sufis
موارد سکوت	lacuna / non liquet
نحلہ	school of thought
لقمان	Luqman
هِل	cardamom
چشمه از چشم‌بندها	an instance/some kind of legerdemain
یاقوت	ruby
the lid of a box	سرپوش/در/درب يك جعبه
خارج کردن	leave the arena
دانگ	one sixth of an immovable property
عباراتی	words , phrases
چاغاله	green fruit mostly green almond and apricot
خرد نردن	It must be a typo!
کنار	adjacent, close, side, some kind of hug
هرانچش	whatever had been removed reduced from him
کش	from him, from whom, from God
گویند کاه را می‌رباید	It is said to attract straw.
متوجه شدن	understand, find out
در ذات خدا	In God\'s Essence
میزان برداشت آب از سفره های زیر زمینی	the rate of groundwater storage depletion
ماشین آسفالت ریز	asphalt machine
نیم نگاهی به گذشته، چشم اندازی به آینده	A glance at the past, an overview of the future
سررسیدن	be over
به انتها	to the end
گشنمه	I\'m hungry
تیشه	Axe / Hatchet
کج‌بیل	hoe
پیش آوردن	express servitude and hubmleness:کفش کسی را پیش آوردن
هشدار	Alert / Warn
قلب تپنده خلیج فارس	The Beating Heart of the Persian Gulf
شرکت تعاونی	cooperative company
نوار دور درب	door (insulation) strip
میل فرمان جلو از جعبه تا سگدست	front steering rod from steering gear to axle pin/steering knuckle
بوش موجگیر	Baffle sleeve/bushing
بوش تعادل	balance bushing
بوش مندل	mandrel bushing
در بر گرفتن	to embrace, to include, to involve
همچنان	still
پایه ساز	foundation-maker
باستان شناختی	archeological
به عنوان پیش نیاز	As a prerequisite
مشابه هستند	they are similar
دوغاب	grout
مركز آموزش علمي-كاربردي شركت خدمات دريايي تايدواتر بندرانزلي	Bandar Anzali Tidewater Marine Services Co. Training Center for Applied Sciences and Technology
نازک دوزی	delicate sewing (job)
کاش تو زن من بودی ...عشق منی	I wish you were my wife...you're my love (sweetheart)
شعله ور سازد	set alight
ز باطن ابر گريان	a crying cloud on the inside
تو را پرستم	Thou I worship, (You I worship ) Look below for explanation
پرتوقع	overexpectant
توری پشه‌مند	mosquito-net
چون	because
doost dashti? goftam khastegit dar bere	Did you like it? I thought maybe you wanted to stretch out and relax, (get rid of your exhaustion)
هر رسمي كند آغاز	any tradition he begins/resorts to
شیوۀ مسیحی تربیت فرزندان	educating children according to christian values
پای	bring up (something/the subject of)
اصلا	at all
جرّ و بحث	long noisy argument
عطشی بیمارگونه به	a crazy passion for
بسراغم	Came to me; came to my sight; came into my mind
شهريزان	It is a proper name
گل نسرین	jonquil
پشتوانه	help, support, aid
بلوک نفتی دیر	Dayyer Oil/Petroleum Block
محاسبات عددی	Numerical Computation
مهندس مکانیک حرارت وسیالات	Mechanical Engineering, Heat and Fluids
va garnah	Otherwise
gozide-ye aayaat	Selection of verses
استاندارد اطمینان خاطر می آفریند	standards create assurance
هشتمین مسابقات فوتسال کشور	8th National Futsal Tournament
به نظر کافی میرسیدند	appeared to be enough/sufficient
در نرم‌افزار ای‌سورد	in eSword software
حیات داران	The Hayatis (a family name)
نوادگان درجه یک او	his immediate grandchildern
حق کشی	trampling on others' rights
تحولات	developments
صوات الله علیهم اجمعین	May God\'s peace be upon them all!
ولایت و امامت مولی الموحدین	guardianship and leadership of the lord of monotheists
در عین واقعیت مثلِ	while quite real
Migam toam kalato kachal kon	I tell you that you shave your head bald too
چند جا یکی دو نفر	here and there one or two
از اذان غروب اثر بهرام صادقی	From the ّsunset call to prayer by Bahram Sadeghi
رسید	reached/arrived/came to
آبخیزداری	Watershed Management
بیگانه پرستی	xenophilism
مدعیان ذکر رحمت حق	those having a claim to remembrance of God\'s mercy
بساط	trappings
کمکی چشمگیر می‌کند	helps significantly
مجسم ساختن	envisage
اتهام جعل عنوان	accusation of impersonation
داده	data, information
می‌پردازد	addresses, discusses, reviews
توی کدام باغ هسبی؟	are you with it?/you\'re not with it
taguti	طاغوتی
مرجع تقلید	source of emulation
درون بين	insightful/introspective
از آنطرف	on the other hand
یا لااقل	or at least
کثیرالانتشار	mass-circulation newspaper
ده کوره	the boondocks/the sticks
آهنگینش	rhythmic
خدا کنه	God willing, I hope
حراست دانشگاه	University Security Office of the University
نفري	25-person/member
حبس تعزیری	discretionary imprisonment
با اینحال	in spite of this, despite, notwithstanding, however, even though
دفترچه	(installment) payment coupon book
روزگار	time, days, era
گوئی زود در یافت	He seemed to have noticed it; he seemed as if he (had) noticed it
تاثیرپذیری	influenceability
سردفتر و دفتریار	Notary Public and Notary Public Assistant
اینو باش	check this/him out
نف	Subjective Adjective
بی معرفت	unappreciative
با توجه به	Given
نکند یا نکنه	(you/he/she) better not (have)
نرسیده به	before, prior, before you get to, before you arrrive at
چند نفر هستید؟	how many in your group/party?
اول خیابان	head of the street
فرهیخته	educated
سایاسان	Saymakh; to count, Sayasan, you count, value, an imported term from Azeri language into Farsi
آمار و نمودار تحليلي عملكردها	statistics and analytic graphs of functions
گروهک	group
سازوکارهای مردم سالاری،	democratic/democracy mechanisms
داریمیرم	daaram miram
کنکور	university entrance exam
horosht (?)	خورشت (khoresht)
تاریخ تأسیس مؤسسه علمی آزاد ارم	Date of Establishing Eram Open Academic Institute
كارنامه پژوهش هنر	Art Research Workbook
ز فرق فرنگان مشکین کلاه	with the heads of black-helmetd aliens
که از ضرب آن شد سر رخش خورد	whose strike shattered Rakhsh's head
جهان را به دریای خون کرد غرق	immersed the universe in a sea of blood
خرامان از آن دشتگاه نبرد، خرامش سوی لشکر شاه کرد	Stalking like a peacock, he strutted form the battlefield toward the King's army
بدینسان خروشان به شمشیر تیز، درآورد در خیل دشمن کریز	This way, using a sharp sword, he/she made the enemy's army escape
دویدند کردن زنان بی دریغ، بدان بدنهادان نهادند تیغ	Women ran earnestly and put the wicked to the sword
فوق توزیع	super distribution
جوی	atmosphere, space
پيش پا	before; in front of
جهاني شدن به معناي جهاني سازي،	Globalization as globalism
معرفت شناسانه	epistemological
تعامل گرايي	interactionism
به لقمان حکمت آموختن	teach your grandmother to suck eggs/to teach Pope how to pray
بچه سر راهی برداشتم پسرم بشه، شوهرم شد	I took the abandoned boy to be my son, but he became my husband.
تعلق خود	belonging
طرح دوفوریتی	double-urgency plan
خوشقد	well proportioned
مبارک نما ای عیسی	O Jesus, bless...
پارسا	from Pars, pious
در کل آرامتر	generally quieter/calmer/ more serene/ more placid
Gol e khandan keh nakhandad cheh konad...\?!	What can a luaghing flower do if it does not laugh?
با سنی بیشتر	of a higher age, older
فرا	ultra; super; above; over; cross; across
کلوخانداز را پاداش سنگ است	One who throws a clod deserves to be hit by a stone
نقاط آمادی	supply points
مرخصی بدون احتساب سنوات	Non-count periods of leave (of absence)
درس همنیاز	corequisite course
دوره پیش دانشگاهی	pre-university course
سرکار خانم مهندس ...،	Ms/Mrs .... (Eng.)
حالت سکون (مددت زمان توقف) دستگاه	idle, standby
نقش مقادیر سرعت در عملکرد دستگاه	the role of speed values in the performance of the ...
در نوار کناری و پائینی صفحات کاربردی دستگاه	in/on the side and bottom margins of the device guide(book)/application pages
مقادیر دستگاه در تعداد پران تاخیر رفت و برگشت	amount of the system in the number of ejector delay for reciprocation
به وضعیت دستگاه عدد میدهیم	we assign a number to the status of the system /apparatus
نقش شیب افزایش سرعت در موادگیری دستگاه	the role of slope's rising speed in material uptake of the system / apparatus
برایم به صورت عادت در آمده بود	they had become habits; they had turned into habits
از بس تکرار شده بود	because it was repeated so much/ so many times
درشت	large; big
خبر نگاران	reporters
عیب یابی این دستگاه سادست و به ... میخورد	troubleshooting this device is simple and....
خیالمون نسبت به قطعات کنترلی راحتر بشه	(may) our mind(s) be put at ease regarding the the control devices/parts
فکر افراد را به خود مشغول کرده	...has got people wondering (about)...
این دستگاه .... جوابشو پس داده	this device speaks/can speak for itself
ماشین آلات و تجهیزات استحصال مواد موثر	machinery and equipment for obtaining effective materials
روستای پاکستانی واه	the Pakistani village of Wah/Vah
ابری مه آلود	(a) foggy cloud
tou baziye sakhtemoun sazi vaghti mikham begam (yedoune tak bezar??)	Put one single (block)?
بررسی صلاحیت	investigating the qualification of ...
نمایندگان مخالف و موافق	supporting and opposing deputies
شومیزیه	chemisier
پاسخگویی در چیدمان راهبردی و مدیریتی نظام ها	responsiveness in strategic and manegerial arrangement (structure) of systems
استشهادیه	affidavit
دولت تحصیلدار/ رانتیر	rentier state
کشباف	knitted work
از ترکی او طه	From ethymon Aoteh (A Turkish word which 'otagh' or room in persian is derived from)
استاندارد سازی تاسیسات پذیرایی حاشیه راه ها	standardization of roadside rest facilities
ملحفه یکبار مصرف	disposable sheet
رشته مبانی و داس پیشرفته و برنامه نویسی	fundementals of DOS, Advanced DOS and programming
با مجوز رسمی از سازمان فنی و حرفه ای کشور	officially certified/licensed by the National Technical and Professional Organization/Association
نخواستم مصدق اوقات بشم.	I didn't like/want to trouble/disturb you.
احمدی نژاد	Ahmadison/MacAhmadi
ڪسِ گربه	cowrie/cowry shell
خیار غبن فاحش	option of gross fraud
Iran zamin	ایران زمین
Khoshgele Patyare	pretty bitch
دریافت پورسانت	receiving a percentage/commission
انجمن صنفی در نمایش محصولات	guild/union association in products display
عمده فروشی مواد اولیه	wholesaling of raw materials
تجهیز کارگاه ذوب شمش ریزی	equipping the ingot workshop
در باب همۀ اموری	on all the matters/affairs which ...
همكاران طرح	Project/Plan Partners
دوره کارشناسی ناپیوسته	discontinuous Undergraduate course; discontinuous BA course
the purification of the Persian language	خالص سازی/پاکسازی/ پالایش زبان فارسی
معرفی کردن	introduce; describe; explain; recommend
سند راهبردي	strategic document
baba - does baba just means father or are there any other meanings	1. dad, 2. grandfather, 3. a title for sages 4. guy, person (a disrespectful title), 5. man/dude
بناهاي سنگي كه بر پيكره خاك سايه مي افكنند	stone buildings casting their shadows on the earth
روزگاري كه مردمانش ايستاده اند در اوايل تاريخ	the era whose poeple are standing at the onset of the history
اساطيركهن را به گوش گهواره ها لالايي سر مي دهند	... lullabying anient myths to cradle ears
شببوي or شببو	Stock / Matthiola spp
دلچسب	charming, pleasing( the heart), lovely, attractive
!نامه يادتان نرود	Don't forget the letter(, please)!
تفهیم اتهام	explanation of the charge
نقشه کشی صنعتی	industrial drafting
جاى بقيه فاميل خالى	Wish(ing) the rest of the family were here.
kardan	do, work
چلو	Chelow or polow
naziiiiii and Jigar/jigaretooooo/jigari	You ar cute and sweet/sweetie/hon
در دو طرف برج کلاف شوند	Hank/fit into two supports at both ends/sides of the tower
محورهای مستقیم الخط میان	rectilinear axes between ...
رینگ سازه	rings of the structure
بلند مرتبه سازی	Highrise construction
به هیچ وجه مد نظ	by no means to have in mind
تبلیغات گسترده	widespread/extensive propaganda/advertising
fargi nemikone	it doesn`t make a/any difference
khoshhal misham bishtar bahatun ashna besham shomare mobaile man	I'd like to know more about you. My cell phone number...
برنامه ريزي توسعه شهري	urban development planning
قتل غیرعمد	manslaughter
جایگاه متهم	Dock
طرح هاي تفضيلي و پژوهشي	detailed and research (development) plans/sketches
اجراي پروژه و طرح هاي مطالعاتي	execution/implementation of project and study plans
بدنه و سيماي شهر در عمران شهري بسيار مهم است	In urban development, the framework and appearance of the city are very important.
طرح هاي بالا دست شهري	urban upstream plans/projects
كلان شهر	megalopolis
گردشکار	procedure
حسب ارجاع	upon my referral
صدور قرار تامین دلیل	issuance of a writ for evidence gathering
miry miry peidat nemisheh	long time no see!
امکانسنجی ایجاد تعاونی های گردشگری در ایران	A feasibility study for tourism cooperatives in Iran
آيين نامه اجرايي ارزيابي مناقصه گران	executive guidelines/procedures for bidder evaluation
هيئت ترك تشريفات مناقصه ومزايده	Bids and tenders exemption/exception committee
تجهیزات جانبی	accessories/ancillaries/peripheral equipment
در آستانه برگزاری ...	which are about to be held
ارائه مشاوره و خدمات فنی	Providing consultation and technical support/services
گرایش .... فرایندهای تولید	Subdiscipline.... Production processes
بوي خوشي را استشمام كردم	I got a whiff of a lovely aroma/ smell
تمرکز و عدم تمرکز	centralisation and decentralisation
ارزیابی عملکرد	Performance assessment/evaluation
مركز اطلاع رساني	Information Center
برای ایفاء تعهد به نرخ موضوع تعهد ایفاء نشده	for the fulfillment of the obligation at the rate specified in the unfulfilled obligation
will have developed some understanding of the opportunity space	به درکی از فرصت موجود برای ... دست خواهند یافت.
The resource view	منظر منابع
relevant knowledge possessed by others	دانشی که دیگران در این زمینه دارند
confers competitive advantage and the potential for sustainability	مزیت رقابتی و پایداری بالقوه را به همراه دارد
امکان سنجی اکوتوریسم روستایی از طریق تعاونی های روستایی	a feasibility study of rural ecotourism through rural cooperatives
dokhtaraye Irooni	Iranian girls
گیاه پیوندی	engrafted plant
حساب ارزی	Foreign currency account
باعث افتخار من هست که	I have the honor to/of....
مع اواسطه به موجب سند قطعی	with intermediaries based on the final document
حق عبور از مورد ثبت گواهیی می شود	This is to certify the right of transit on/across the registered item/issue/case
کف برروی عرصه و مشمول قانون بوده	The floor area shall be within the building line and subject to the said law/restrictions
گواهی پایان کار	Construction Completion Certificate
با مطالعه پرونده ثبتی پلاک مورد تقاضا	Having reviewed/studied the registration file of the lot under application
پی به پی	foundation to the foundation
صورت مجلس تفکیکی پلاک ثبتی	minutes/proceedings of the seperation of the registered lot
چشمان آبي رنگش به رنگ آبي گلها بود	Her blue-colored eyes were the blue color of flowers.
نانوا هم جوش شیرین می زند!	the baker is anxious about his sweetheart too
Have a nice day sweetheart!	Rooze khoobi dAshte bAshi eshgh-e man!
ارتباطات تصویری	Visual communications
تسویه حساب منوط به تحویل اصل این مدرک است	settling the account is contingent on the delivery of the original of this document
گاهنامه	irregular periodical
customs	گمرک
استفاده از تراکم ساختمان همجوار	using the density of the adjacent building
مراتب فرماندهی	command hierarchy/echelon
Vaghti Baroon Mizane	When the rain hits...
'english to farsi' and 'english to persian'	آنگلیسی به فارسی
مقاومت سنج	resistance gauge/ meter
گرگ و میش	dusk; twilight
بخش سنگ شکن	crushing department/plant
آزمایشگاه شابلون سازی	screen printing laboratory
کلیه امورمربوط به نقل و انتقال را عهده دار شوند	to undertake all affairs concerning the movements
واگذاری امور به مسولان و متولیان	leaving the affairs to authorities and administrators
اردوهای تدارکاتی	preparatory camps
اعتبار آن پيشتر به روش آلفای کرونباخ 86 صدم محاسبه شده بود.	its reliability had (already) been calculated as 0.86 by Cronbach's α (alpha) measure
اعزام شده به مسابقات ورزشی به ميزبانی استان گيلان	dispatched to the sports competitions hosted by Gilan province
شرکت کنندة فعال،شرکت کنندة غيرفعال	Active participant, inactive participant
مسابقات ورزشی که در نقاط مختلف کشور برگزار می شود	Sports events held/convened througout the country/in various parts of the country
بازاريابان و سازمان دهندگان رويدادهای ورزشی	Sports events organizers and marketers
سربار	A burden on your shoulders
شسکت	شکست
خسته نباشيد	Keep up the good work
بازساري بافت هاي فرسوده شهري	the reconstruction of worn-out/time-worn urban textures
فضا شفاف و آشکار باشد	Should the space be clear and open?
تکه های مو	locks of hair
روی موها و زیر موها	the top and bottom of hair
تقسیم بندی چهار تایی	fourfold partitioning
جواز تاسیس آموزشگاه آرایش و پیرایش	license to establish a hairdressing and beauty school
متعادل سازی چهره و پوست	face  skin balancing
مربی آرایشگری	beauty instructor
کامفولاژ	camouflage
tourism	tourism
قلم کاشت ناخن	nail inserter
معاون فنی و بهره برداری	technical and exploitation deputy manager
مسئول امور حقوقی	in charge of legislative affairs
شهرک	Development
felez yab... ganj yab...	metal detector
معارف اسلامی1	Islamic studies (I)
متون اسلامی	Islamic Literature
تربیت بدنی	physical education
زبان تخصصی	Specialized Language
آیین نامه اجرایی	executive bylaw
برگ معملات نیم برگی	Transaction Sheet (Short Form)
یک بار امتحان کافیه	Once you try it...
شهرستان	city/town
I WANT TO KNOW THE TRANSLATION OF KALANTARI AND DIPLOM VAZIFE	police station/high-shool graduate conscript
خطوط حامل	Stave; staff
ارفاقي	supplemental/bonus/extra
رسته	Category
گروه	grade/grade level/grade code
حكم اجراي قانون مديريت خدمات كشوري	State Services Management law enforcement order
متبوع	respective
کفشهات لنگه به لنگه است !	Your shoes are ill-matched!
عکس باید تمام رخ و با زمینه سفید باشد	The photo should be full face, and in a white background
خدایا تو آنی که میدانی	O Lord, thou art that which/what/whom thou knowest
به چه اوج ها که نمی رسیدم	What heights I would have reached
سی دی خش داره !	The CD is scratched!
فارغل التحصیلی 15 دوره دانشجوی دریانوردی	graduation of 15 batches of maritime students
مدیریت بیمه شخص ثالث وسایط نقلیه	Third Party Insurance Administration
آمریت بیمه موتر	Auto Insurance Department/ Office of Auto Insurance
خودکفایی	self-sufficiency
قضاوت جمعي	Pooled judgment
Rasti, khers-e Maisa chetore?	Anyway, how is Maisa`s bear?
یا به اندازه آرزویت تلاش کن و یا به اندازه تلاشت آرزو کن	Either try as hard as you wish or wish as hard as you try.
khalesane	genuine
دستگاه ساخت پیچ و مهره	Tap and Die,
دستگاه آسیاب لاستیک	tire grinder
khosh zire del zadan	to become full of oneself/to have too much of a good thing
فروش بدون نسخه پزشک ممنوع است	Subject to medical prescription
Joon marker after Persian last name	dear/sweetheart
khayli awkward bood. faghat man tanha boodam ba Ryan	It was so awkward. It was only Ryan and me there/Only Ryan and I were alone.
درخت سمر	samar tree
pu:shi:dan or bu:shi:dan	pu:shi:dan (پوشیدن)
دستور نگارش	principles of writing
کشوری را تیول خود کرده اند	They have turned the country into their personal fiefdom
zamon	In Azeri and Uzbk turkish: زمان، دورانTime, duration
افتادگی شانه	Thoracic Outlet Syndrome
وجه بهر مبلغ و بهر مدت و بهر میزان بهره	Funds of any amount, any period and any interest rate
آب شکن	cutwater
فیزیک حرارت	Thermal Physics
شرکت تعاونی کشاورزی تامین نیاز دامداران سیدان	Seyyedan Agricultural Cooperative for Providing Stockbreeders' Needs
عبور از مد	Crossing the high tide!
bolandgoo	bullhorn, megaphone
شرایط ضمن عقد یا عقد خارج لازم	conditions stipulated in marriage certificate, /through a separate binding contract
مبایعه نامه	Purchase and Sale contract/agreement
قیاس مع الفارق	comparison of incommensurables
آینه آمار	mirror of statistics
عطای آن را به لقایش بخشیدند	They abandoned the attempt
آتیش گرفته بود	had been driven mad, had been rendered crazy
سگرمه اش تو هم رفت	frowned
خونم به جوش آمد	I boiled with rage/anger
دل کسی خون شدن	To be afflicted by sorrow
جگرم سوخت	to be moved with compassion
دلخور شدن	to be annoyed
دل چرکین	hold/nurse a grudge
خاک به سر شدن	To become bereaved
دل توی دلش نیست	she has butterflies in her stomach
سرتیپ پاسدار	brigadier general, brigadier
راهنمای و رانندگی	traffic
نیروی انتظامی	Islamic Republic of Iran Police
دل دادن و قلوه گرفتن	Having a lovey dovey chat
دلم کباب شد	I felt for him/her, I took pity on him/her. I felt empathy for him her
. خون خونشان را می خورد	Their blood was boiling.
خون جلوی چشمانش را گرفته است	He or she was blind with rage
مثل مرغ سر کنده امMesle Morghe sar kandeh am	I am like a chicken with its head cut off
Delam mesle siro serke mijosheدلم مثل سیر و سرکه میجوشه	I have butterflies in my stomach
ماده حاجب	Contrast agent
موافقت اصولی	Agreement in-principle
تکانش گری	Impulsivity
markaze roshd	center for development/development center
projeye tose eye karbordi	Applied development project
nashriyeye daneshgahi	university publication/newsletter
markaze nazarie pardazie eslami	Islamic Theorization Center
مطالعات بنیادی	Fundamental Studies
Chahar sahmeh mosha az yek-sad sahmeh yekdangeh mosha	Four shares held in common out of one hundred undivided shares of one sixth of the whole property
daftare karafarini va estedadhaye derakhshan	Office of Job Creation and Exceptional Talents
نمره نهایی با ضریب 2	Final Score X 2
مدیر اموزشی و تحصیلات تکمیلی دانشگاه	Education and postgraduate administrator
اداره کل اموزش دانشگاه	General Department/Office of Academic Affairs
رئیس کل دانشکده پزشکی	Dean of Medical Faculty
مسؤل فارغ التحصیلی	Administrator of Graduation Affairs
نمره بعدد	score in numbers
امتیاز	Point(s)
نمره بحروف	grade (in letters)
دوره علوم پایه	Fundamental Sciences course
مورد تائید میباشد	is certified
فرزند	son, daughter
بسمه تعالى	In His Exalted (Allah’s) Name
قوانين جذبي	incentive regulations
فضاسازي هاي يك سويه	creation of/creating one-sided climates
دويچه وله	Deutsche Welle
ضریب همبستگی پیرسون	Pearson's correlation coefficient
مقیاس فازی	Fuzzy Logic, Fuzzy Measure
در میان اقشار مردم	Layers, strata
ﺸﻮﺮﺖ ﺘﻭﺪﻮﺯﻯ ﺸﺪﻩ	panty/brief with crotch liner
آنتن دهي	reception
در فراخوان کنفرانس آمده است	In the call for the conference, it says/is stated:
پادمان	work
شورای حکام آژانس اتمی	The congress of IAEA rulers or the board of IAEA rulers
ریاست طلبی	power seeking / in quest of power/leadership
mohandesie Saze	Structural engineering
باز/بسته بودن مدار,کلید	switch contacts/circuit being open/closed
قطع کردن رله	Relay trip
با دقت24 بیت	with precision of 24 bit
کلید فشاری	push-button or pushbutton
کلید تبدیل	conversion switch/button
ترمینال /ترانزیستور دوپایه	Two-legged transistor/terminal
سازمان تعزيرات حكومتي	Governmental Discretionary Punishments Organization
فصلنامه	Quarterly
اداره بهزیستی	(State) Welfare Organization
سال دوم راهنمایی	7th grade (of primary/grammar/elementary school)
شيء وارگي كالا	commodity fetishism
شيء وارگي كالا	objectification of goods/commodities
کتاب در وزن مثنوی سروده شده	The book is composed in Rhyming Couplets
بحر متقارب...	The metrical pattern of motaghareb (sea proximity)
بحر متقارب	Convergent poetcial measure/metre, Convergent type of poetcial measure/metre
بیاض های سخنوری	blank-books for/of eloquence, notebooks for/of oratory,notebooks of eloquent writing
سرودواره	quasianthem, anthemlike, hymnlike,chantlike
Elme harkate Ajsam zire ab	Hydrodynamics
واحد مرکزی خبر	Central News Unit
قره برون	Acipenser persicus (also known as Persian Sturgeon)
سزارين	Cesarean (Surgery)
قرص هاي روانگردان	psychotropic or psychoactive (pills or capsules)
يک فقره چک	a check
khiali negary	Tea-house / Imaginary painting
مداربندی آزمایشی	Breadboarding
نرم افزار	software application/program
تنش	Tension
آرمانشهرگرايي	Utopianism
پيامدها	Outcomes
ديري نپاييد	did not last long
پراش	diffraction
ازخود بیگانگی	Self-Alienation
دکترای افتخاری	Honorary Doctorate (program/degree)
نادقیق سازی داده ها	Data Fuzzification
الگوریتم آزمند	Greedy Algorithm
چشم خمار	languished eye(s)
Serendip	سرندیپ
ﺗﺷﺗﻚ	bottle cap
کرانه نگاری مواج	Moire Contourography
حوزه همگرایی	Convergence feild
فرض متصله	Continuum Hypothesis
be kam ghane boodan	be happy with what one has, contentment
الاکلنگ تاخیری	Delay Flip-Flop
تخلیه ی هاله ای	Corona Discharge
arezooye kham	A vain wish
vasvaseye sheitani	satanic temptation, Satan's temptation
تصویربرداری به روش پویش شکافی	Slit Scan Photography
تغذیه چرخ دنده ای	Tractor Feed
تابع اختلال	Perturbation Function
تابع یکنوا	Monotonic Function / Monotone Function
Divare Shabam Shekaste Az To Az Zolmate Shab Nemiharasam	My night's wall is broken because of you, No longer am I afraid of the night's darkness.
mabada dorughi	I hope you are not going to lie.
ghahr ta rooze ghiamat	I'm never gonna speak to you again!
ساماندهی	organization,order,regulation
Nemidonam manzoret chieh	I don't know what you mean/I don't know what your intention is.
خفانیده	Throttled
سرمایش عمیق	Cryogenics
ضد کف غیر سیلیکونی	Non-silicone based defoamer / Silicone-free anti-foam
ماده تثبیت کننده	Passivating Agent
bishin binim baba	Don't pull my leg, will you?
چربیگیر قلیایی	Alkaline Degreaser
karshenasi peyvasteh /napayvasteh	Continuous/Discontinuous BA/BSc Course
تپ اختر	Pulsar
لجن زدایی در حوضچه های تصفیه آب	Sludge conditioning/removal in water treatment pools
دیگ چگالنده	condensing boiler
فروش فلّه ای	bulk sale
قطبیت نمایی	Polariscopy
تسمه لایی	Spacer Strip
میان لایه ی رسی	clay interlayers
دقایق و ظرایف	precision and subtlety
پلیسه گیر دستی	Manual Deburring Tool
جوشکاری ضربه ای	Percussive Welding
mil gerd-e-Aj dAr	corrugated bar
سقا	water boy
اطلاعات حساب	account information and ATM (automatic teller machine)
ﻜﺮﻢ	The 3 valence salt of chromium, Chromium III salt
بالن ژوژه	Volumetric Flask
شیشه ی در سمباده ای	Ground-Jointed Glass/Flask
سنگ جوش	Boiling Chip / Boiling Stone
میازار موری که دانه کش است / که جان دارد و جان شیرین خوش است	On the ant bearing the grain bring not strife/He is alive and joyous is sweet life
از این حکم از چشمشان خون چکید / ز عالم نمودند قطع امید	Blood they shed hearing the ordinance/ Hope they lost in this world essence
سود 0.01 نرمال	1/100 N (Normal) NaOH
ارلن مایر 500 میلی لیتری	500 ml Erlenmeyer Flask
چو از بهر سرگرمی خود ز شوق / دو جینی کبوتر خرید او به ذوق	as for his own amusement zealously two dozen pigeons he bought enthusiastically
Edare ye Tashkhis e hoviyat	Office Of Identity Identificaiton
ﺁﻻﻴﻧﺪﻩﻫﺎﻯ ﻔﻠﺰﻯ	metallic contaminants
ﻮﻴژﮔﻴﻬﺎ	Characteristics, features
ﻜﻮﺸﺎﺐ	Non-alcoholic beer
صورت مجلس تفكيكى	minutes of demarcation
javabe mano nadari	you don't have an answer for me
Salam Omidvaram sale jaded ro ba 7siny az : 1) salamat 2 ) sar bolandy 3) soror	Hello, I hope the new year with seven seens such as 1) health 2) honor 3) happiness
بابیلیس	Hair Iron or Hair Curler
پیتاژ	pinking shears
کوپ	haircut
库赫鲁德山脉	Kuh Rud
Kavir	salt desert
مواد جرم گير	descaling agents
مرکز فوق تخصصی	Super specialty center
زندگی مشترک	communal life
چک رمزدار	coded/codified cheque
خیابان کشی	Paving / Road Building/ Road Surfacing
systeme Amouzeshi Doreyi	periodic instruction system
انفال	Anfal
بافت قدیم	old/ancient texture
میزانپلی	getting a perm(anent) wave
لایی چسب	interlining adhesive
البته	certainly, sure
entefazeh	intifada
edareh sabte asnad o amlak	1. State Registry of Documents and Landed-Estate Properties; 2. (Explanation)
tabi'yeh	natural sciences
barcheen	Imperative of barchidan
خود امتیازی	self-Kudoz awarding
نوسانگر هماهنگ	Harmonic Oscillator
جابجا شدن دو عملگر	commutation of two operators
نظریه اختلال	Pertubation theory
حالت جامد	solid state
صدور امثال این قبایح حرص و طمع	...performing such evil-doings is avarice and greed...
jahan khishi	globalization
wajheh tasmiyeh	etymology, appellation, nomenclature
dasteh Darzeh	the number of the joint sets
ghAbeliate taghire zabAne system ba estefade az mazhole tarife zabane jadid	Changeability of the/a system language through/using a/the new language difining module.
bahregiri az yek system ya narm afzar	(Use,utilize, utilise,employ and even apply)ing .... a sysetem or software
poshtibani az yek narm afzar ya standard	Support Serves Right.
bargozArye emtehane ta`ine sath	...placement test
ghAbeliate ta`ine sathe sakhtiye soAl	the possibility/capability to determine the difficulty level of the/a question
پز عالي، جيب خالي (poze Ali jibe khali)	great boast, little toast!
to bish az had be un vabaste shodi	You have come to be dependent on her/him excessively/too much.
pahnehaye kalane meghyas	macroscale widths
Ghazaf	false accusation of unlawful intercourse, false charge of fornication
osture sAzi	mythologizing; mythmaking
شمرتال _____ بخش ______ دمستال _____ شمر/رنستا	City/town/rural area/ village
oon khodesh ham pashi moone	He is regretful himself/He is sorry to have done so himself.
clip tasviri 4th namAyeshgag international tasisAt va system haye sarmAyeshi va	4th Iran HVAC systems  instalations international fair (video) clip
Omr e mofid	Life Span
man miresunamet	I'll take you there.
az cheshm-e-din didan	to put it down to the religion, to blame the religion for it
koordelAn-e-khofAsh sefat	blind-hearted and bat-like people
moghadas maAb	sanctimonious
midunestam ye etefaghe bad oftade	I knew something bad had happened.
amozeshe pishgiri az aids be daneshamozan	aids prevention training for students
sAbeghe anjame amalhaye sarpayee be sorate motenaveb	the experience of out patience operation with alternative speed
masoole comosione pezeshki moafiat az sarbazi	the person in charge of medical active service exemption commision
hazrate ali dar nahjolbalaghe takavare sokhan ra be jolan avardeh ast	His Holliness Ali has flown on the combatant of speech with full career in Nahjolnbalugheh
osul va mabadiye din	the principles and fundamentals of the religion
bAz nAmAi-e-tabiat	re-creation of nature
mAbAni-e-honar	fundamentals of art
kelas-e-AzAd	open classroom
tu estevaj kardi?	Are you married?
kamAle motlagh	(the) Absolute Perfect
ziaratname	pilgrimage book
nemitoonest ro haresh harf bezane	s/he could not override his words
HAGH E MATLAB RO ADA KARDAN.	manage to reasonably examine the issue
asma'al hosna	The Most Beautiful Names of Allah/God
ba gerayeshe modiriyat	with a management inclination
markaze tebbi	Tehran Chlidren's Medical Center Hospital/The Hospital of Tehran Chlidren's Medical Center
vahedhaye morede pazhuhesh	the units under study/units being researched
pendar nik , goftar nik , kerdar nik	Good thoughts, good words, good deeds
nemidunam chera har ghadr be oon negah mikonam sir nemisham	I don't know why the more I look at him/her the more I feel a craving to keep on looking.
saresh gij miraft.	She/he was feeling giddy/dizzy, She/he was reeling, She/he was staggering
oon adat nadasht	He/She was not used to
mohavateh sazi	Landscaping
shart mibandam gand bezani, pesar jan	boy, I bet you will end up in a mess
kife ehya	recovery bag
otaghe kare tamiz	clean working room
آزادٍ اسك كصدر آزاد است	AzAdi is the action noun/verbal noun of AzAd
deklamh	Narration
parvareshi,daryaei	farmed fish, wild fish
chaahaar pareh	tetrastich
bad az raftane A , D afsorde shod	Once A was gone, D got depressed
fekr mikardam in faghat yek havase zoodgozar hast	I thought it was but a whim.
nemitoonest jaye khalisho tahamol kone	she/he couldn't stand (bear with) his/her absence ...
oono vase ye modat bebarim kharej	(we may/can) take him/her abroad (out of country) for a while
bar khalafe meilam	contrary to my desire / inclination
Salam Agar dost dashtid be in email, javab bedid	Hi. Please reply to this e-mail should you like to/ if you'd like to.
faghat khahesh mikonam dige mano to khoone tanha nazar	I have only one request. From now on don't leave me home alone anymore
majboor bodam onja bemoonam va karamo tamoom konam	I had to stay there and finish my work
Culture-bound Terms	vAzhegAn-e farhangi
man ke mazerat khastam	I appologized, though
bebakhshid dir shod rafteboodam company karhamo anjam bedam	Sorry for being late! I had something to do at the office.
tamame kar hamo anjam dadm	I did everything I had to
bavar kon shokhi nemikonam	Be sure, I'm not pulling your legs
to kheili loos va bad akhlagh shodi	you turned into a very spoilt, grumpy person
ba khodam boodam	I was talking to myself
ba kee boody?	to whom were you talking?
be to rabti nadare	It's none of your business
begozar man begozaram dahanat{ghaza bezaram dahanet}	let me hand-feed you
ama to ke kheili kam khordy	but you barely ate
to faghat vase man sakhte shodi	you have been created just for me
az dard faryad mikeshid	he/she was screaming in pain
shookhi kardam	It was only a joke
hanooz dost dari barim safar?	Do you still want us to take a trip?
vaghti khejalat mikeshe beshtar asheghet misham	Your blush(es) makes me love you even more.
shoharam mekhad mano bebare maheasal	my husband wants to take me on a honey moon trip
aslan maloom hast to chet shode?	What on earth is wrong (with you)?
mano beboos ama na intory	Kiss me but not that way!
khob boland sho dige	OK, come on, stand up!
saresh boland dad keshid	She/He yelled at him/her at the top of his/her voice.
thomas moghavemat mikone	Thomas resists.
harfe ahmaghane'ee zadi ke hata fekresh ham mano azar mide	you said such stupid words that even thinking at them makes me sad
AbdAr khAne	Refreshment Room/ Canteen
faghat choon man yek shokheie kochak kardam?	only because I made a small joke?
tilu'	tilu', the bloodless bullfight of Emirate
Safire Iran Dar Canada	IRI's/ Iraninan ambassador to Canada
omure hesbi	Probate Cases
Pasokhe Dandanshekan	retort
salam khobi baba delam barat tang shode agha chera javabamo nemidi	Hi, Pal! Are you fine? I really miss you. Why don't you reply to my messages?
Halet Ro Migiram	I'll give you a hard time,
gostarde	wide/extensive/vast
fa'AlAn	activists
bavar kon manzoori nadashtam	Believe me, I didn't mean it.
oono ghelghelak dad	he/she tickled him/her
be delam sAboon zadeh boodam	I had the tickling dream of a nice rest for the weekend. (also 4 choices in the explanation)
jaael	forger
vakile sazesh	counsel, arbitration counsel
etebar	credit
eghame	to litigate; to bring a claim before the court; to initiate or institute a lawsuit
akhz	RECEIVE ; COLLECT
daavari	Arbitration
barge sodoore ejraei	writ of execution
ta'min	security
da'viye moteghabel	Counterclaim
jalb	COMPELLED INTERVENTION
tashkile parvande	draw up an inventory or making of an inventory
zire nazar	under the supervision of
bela mane'	allowed, permissible,
ta'ahod aavar	binding
fasli	sequential (structure of the poem)
kesho	Main menu of a program
rokh	Face or group
daftar	Notebook
hekmi	philosophical
tazaeif	weakening/ debilitate
bahre moteghareb	Convergent poetcial measure/metre, Convergent type of poetcial measure/metre
taghriraate salaase	triple manifesto(e)s
panj gaane	quintuple
hekmi va ghenaei	philosophical and inductive
dore-ye kArshenAsi az DAneshgAh-e AzAd-e EslAmi	BA degree from the Islamic Azad University
bar avardan	live up to, meet
sangin	hard (water)
esterahat dadan	to help relax
amlaahe badan	mineral
ham masraf	(Drinks that) can be consumed together
chafiye, kelash	kelash must be short for Kalashnikov
radif	rhyme
haft orang	seven skies
divan	collection of poems
masnavi ma'navi	ethereal couplet-poems
golshane raz	flowerbed of secrets
kolliat	Kullliyat
5 ganj	treasures
manteghottair	The Conference of the Birds
rang mizadi	You dyed
daane daane	knot by knot/piece by piece
yadam tora faramoush	You forgot the term, and so lost the bet!
yaal be baad	lose so easily
reshtehaaye haft gaane	The seven university disciplines
moghavemat take mehvari sang bekr	The uniaxial resistance of virgin boulder/rock
zarib pavason toudeh sang	Poisson's ratio of the mass of boulders
nerkhe arz variznameyi	The statement rate of exchange
tasvir bardaari	taking picture
mavadde zaaye'	residue
gheyre nafti	non-oil
daame zende	live cattle
Mazmoun Lah (Arabic used in Farsi tender)	the content thereof, the content of whcich, its content
koravi/unifiyner	spheric/spherical-Unifier
ensan madari	humanitarianism
bayane tasviri	To picture / express in pictures : (v.) representation made by painting, drawing or photography... e.g.: to picture satirically
darkhor	deserving
lohe taghdir	appreciation certificate / licence
behzisti	well-being
nAbehanjAr	abnormal
chAlesh	challenge
sakhto saz	construction
mardomi	popular
shahrvand	citizen
zistgah haye mohiti	habitat
shahr neshini	urbanization
hey'ate dAvarAn	jury
diplome eftekhar	honorary diploma
door az vatan	an ever-expatriate soldier
gheyre faransavi	non-French
narm kardan	win over, convince, persuade, entice
ham band	ward-mate
an ham che moddat	for how long a period
tang cheshm	slit-eyed
hamana	Having volunteered, I was taken prisoner after just a few days.
be manzur-e arj nahAdan be	in appreciation of
hey'at-e elmi	faculty
sakhte va pardakhte	ready-made
karmand	civil servant
tanzime khanevadeh	Family Planning
behdari	dispensary
tavan bakhshi	rehabilitation
koshtiye farangi, koshtiye azad	Greco-Roman wrestling ; free-style wrestling
tavaan mandi,radde pa,raah andaazi	capability ; footprints / foot track ; start(sth.) up
sofaline,ma'anavi,kargah,mardom shenasi	ceramics / baked clay- / earthenware ; workshop ; anthropology
marasem baran khahi,hamame vaziri,gooyeshe mahalli	rainmaking ritual ; Vaziri Bath ; dialect
movazebeh khodet bash	take care of yourself
Mesghal, Mehriyeh, Nafagheh, Ojrat-ol-Mesl	a unit of weight, nuptial gift, alimony, rental value
raile marzi, marze bazargan	frontier/border railway ; Bazargan borderline
service kashti va rail,namayandegihaye motabar,	(cargo) ship liner and railway ; accredited agencies
ba dar ekhtiar dashtan	possessing/having
ehteraman be estehzar miresanad	Dear Sir, Madam, etc.
leza lazem midanad,matalebe mashroohe,modiriate mohtaram	Therefore/ so it is necessary ; detailed subject ; respectful manager
sherkate mohtaram,ghabele tavajjoh	respectable company ; noticeable / considerable...
be manzoore be vojood amadane emkanate bishtar	in order that possibilities / facilities be provided...
mahmoolate kharidari shode,	purchased goods / consignment
kala be soorate falleh, moshtarakol manafe.	commodity / goods / consignment in bulk ; commonwealth countries
emkanate vasie namayandegiha, jam avariye kalahayae groupage,	extensive/broad capabilities/capacities of agencies ; collecting the groupage / commodities/ goods..
tedade motanabeh, dar ekhtiar dashtan, behtarin nahv	enough / considerable ; having / possessing ; best ways / methods
kadri mojarrab,aghsanoghate keshvarmatalebe mashroohe	experienced staff / personnel ; all parts of the country ; detailed contents
gomrokate voroodi, gomrokate maghased	import customs duties, destintions customs (offices)
